 230 230 225 231 231 220 206 228 224 216 218 218 208 196 216 229
 229 239 240 238 238 239 239 238 237 237 237 235 236 236 235 234
 224 237 239 238 240 238 235 236 237 235 237 235 235 233 232 232
 225 237 237 238 237 236 236 238 236 237 238 235 234 233 233 230
 228 235 237 237 236 221 165 188 208 183 197 230 232 231 232 228
 227 235 236 236 234 201  31  33  36  33  33 213 230 230 229 233
 231 234 235 233 234 200  26  32  32  32  39 218 229 231 228 228
 230 232 235 234 233 191  26  30  31  32  25 211 229 229 228 228
 228 231 233 233 231 186  24  31  29  32  29 195 227 226 226 228
 226 232 234 232 232 202  18  22  15  20  20 199 227 227 226 226
 225 225 146 155 127 131 133 118 168 143 117 209 226 226 224 223
 216 216  45  25  27  73 227 228 226 226 227 227 227 225 223 222
 216 214  40  28  25  76 225 225 226 226 226 225 224 222 224 223
 218 208  28  25  15  77 226 225 226 224 225 224 222 223 221 220
 217 207 109  90 128 150 223 224 225 223 222 223 221 221 220 219
 218 225 227 226 224 224 223 223 223 223 223 222 219 217 217 216
 225 220 211 219 220 213 204 220 210 199 204 212 204 193 208 211
 228 234 234 234 232 233 233 233 231 231 231 231 231 230 230 229
 228 233 234 233 234 232 231 232 232 230 231 231 230 228 228 225
 229 232 234 234 233 231 231 232 232 231 231 229 228 227 228 224
 228 231 233 233 230 216 177 195 206 176 189 225 228 226 226 222
 227 230 231 232 230 176  30  36  36  35  47 216 224 226 224 226
 228 230 229 230 229 173  20  27  27  28  41 218 224 225 224 223
 228 228 229 230 229 163  20  25  25  27  24 209 223 223 222 221
 225 227 228 228 227 156  18  26  24  27  25 192 220 221 221 218
 225 226 228 228 226 182  13  18  12  17  19 197 221 220 220 215
 223 219 149 161 130 122 117  99 139 122 112 209 220 218 219 218
 218 204  31  29  29  79 222 220 219 219 217 219 220 219 217 218
 217 201  24  24  22  82 222 220 220 219 219 219 218 216 217 214
 218 194  17  19  15  82 221 220 219 218 218 218 215 215 215 213
 218 199 100  85 119 147 218 217 218 216 216 216 213 213 212 209
 218 219 217 214 214 216 218 217 217 216 215 214 213 212 210 208
 220 216 208 217 213 205 198 215 209 198 200 204 194 183 204 209
 227 234 232 233 232 232 233 233 231 231 231 230 231 229 229 226
 226 233 233 233 235 232 231 232 233 230 231 231 230 229 229 221
 228 230 232 233 232 231 232 233 232 232 232 229 229 228 229 219
 228 230 232 233 230 217 173 196 207 186 195 225 228 227 227 219
 226 229 231 232 230 172  35  47  48  44  57 215 226 227 225 223
 228 230 229 230 230 161  20  26  27  28  50 209 225 225 224 218
 226 227 228 230 228 164  19  25  25  26  29 208 224 223 224 214
 225 227 228 228 227 163  19  25  23  27  32 200 222 222 222 212
 224 226 229 228 227 184  14  16  13  17  26 200 221 221 222 208
 224 215 152 169 142 131 114  95 133 117 104 206 221 219 221 214
 219 187  39  38  32  89 217 215 218 217 217 219 221 219 218 216
 220 180  26  23  23  95 220 221 220 219 220 219 219 217 219 215
 217 183  18  19  15  94 219 220 220 219 219 219 217 216 216 211
 218 186  84  77 113 149 217 218 219 217 217 217 215 216 213 207
 217 218 214 212 212 214 218 219 219 217 216 215 214 213 213 206

 229 234 232 230 228 233 228 228 228 226 223 222 223 220 219 216
 216 235 232 233 232 229 228 228 226 226 224 223 224 221 220 217
 196 236 233 233 231 230 231 229 226 227 226 225 222 223 221 217
 208 236 235 234 232 230 229 229 227 227 226 227 224 222 221 219
 218 235 235 235 230 213 218 211 195 199 209 227 225 224 223 222
 218 237 237 238 197  33  39  25  29  20 117 227 226 225 222 223
 216 237 235 237 183  33  32  32  32  20 143 226 226 224 223 223
 224 237 237 236 208  36  32  31  29  15 168 226 226 226 225 223
 228 238 236 238 188  33  32  30  31  22 118 228 225 225 224 223
 206 239 235 236 165  31  26  26  24  18 133 227 225 226 223 223
 220 239 238 236 221 201 200 191 186 202 131  73  76  77 150 224
 231 238 240 237 236 234 234 233 231 232 127  27  25  15 128 224
 231 238 238 238 237 236 233 234 233 232 155  25  28  25  90 226
 225 240 239 237 237 236 235 235 233 234 146  45  40  28 109 227
 230 239 237 237 235 235 234 232 231 232 225 216 214 208 207 225
 230 229 224 225 228 227 231 230 228 226 225 216 216 218 217 218
 211 229 225 224 222 226 223 221 218 215 218 218 214 213 209 208
 208 230 228 228 226 224 224 222 221 220 219 217 217 215 212 210
 193 230 228 227 226 226 225 223 221 220 218 219 216 215 213 212
 204 231 230 228 228 224 224 223 220 221 220 220 218 215 213 213
 212 231 231 229 225 216 218 209 192 197 209 219 219 218 216 214
 204 231 231 231 189  47  41  24  25  19 112 217 219 218 216 215
 199 231 230 231 176  35  28  27  27  17 122 219 219 218 216 216
 210 231 232 232 206  36  27  25  24  12 139 219 220 219 218 217
 220 233 232 232 195  36  27  25  26  18  99 220 220 220 217 217
 204 233 231 231 177  30  20  20  18  13 117 222 222 221 218 218
 213 233 232 231 216 176 173 163 156 182 122  79  82  82 147 216
 220 232 234 233 230 230 229 229 227 226 130  29  22  15 119 214
 219 234 233 234 233 232 230 230 228 228 161  29  24  19  85 214
 211 234 234 234 233 231 229 229 228 228 149  31  24  17 100 217
 220 234 233 232 231 230 230 228 227 226 219 204 201 194 199 219
 225 228 228 229 228 227 228 228 225 225 223 218 217 218 218 218
 209 226 221 219 219 223 218 214 212 208 214 216 215 211 207 206
 204 229 229 229 227 225 224 224 222 222 221 218 219 216 213 213
 183 229 229 228 227 227 225 223 222 221 219 219 217 216 216 213
 194 231 230 229 228 226 225 224 222 221 221 221 219 217 215 214
 204 230 231 229 225 215 209 208 200 200 206 219 219 219 217 215
 200 231 231 232 195  57  50  29  32  26 104 217 220 219 217 216
 198 231 230 232 186  44  28  26  27  17 117 217 219 219 217 217
 209 231 233 232 207  48  27  25  23  13 133 218 220 220 219 219
 215 233 232 233 196  47  26  25  25  16  95 215 221 220 218 219
 198 233 231 232 173  35  20  19  19  14 114 217 220 219 217 218
 205 232 232 231 217 172 161 164 163 184 131  89  95  94 149 214
 213 232 235 232 230 230 230 228 227 227 142  32  23  15 113 212
 217 233 233 233 233 232 230 230 228 228 169  38  23  19  77 212
 208 232 233 232 232 231 229 228 228 229 152  39  26  18  84 214
 216 234 233 230 230 229 230 227 227 226 215 187 180 183 186 218
 220 227 226 228 228 226 228 226 225 224 224 219 220 217 218 217

 216 217 217 219 222 223 223 223 223 223 224 224 226 227 225 218
 219 220 221 221 223 222 223 225 224 223 150 128  90 109 207 217
 220 221 223 222 224 225 224 226 225 226  77  15  25  28 208 218
 223 224 222 224 225 226 226 226 225 225  76  25  28  40 214 216
 222 223 225 227 227 227 226 226 228 227  73  27  25  45 216 216
 223 224 226 226 209 117 143 168 118 133 131 127 155 146 225 225
 226 226 227 227 199  20  20  15  22  18 202 232 232 234 232 226
 228 226 226 227 195  29  32  29  31  24 186 231 233 233 231 228
 228 228 229 229 211  25  32  31  30  26 191 233 234 235 232 230
 228 228 231 229 218  39  32  32  32  26 200 234 233 235 234 231
 233 229 230 230 213  33  33  36  33  31 201 234 236 236 235 227
 228 232 231 232 230 197 183 208 188 165 221 236 237 237 235 228
 230 233 233 234 235 238 237 236 238 236 236 237 238 237 237 225
 232 232 233 235 235 237 235 237 236 235 238 240 238 239 237 224
 234 235 236 236 235 237 237 237 238 239 239 238 238 240 239 229
 229 216 196 208 218 218 216 224 228 206 220 231 231 225 230 230
 208 210 212 213 214 215 216 217 217 218 216 214 214 217 219 218
 209 212 213 213 216 216 216 218 217 218 147 119  85 100 199 218
 213 215 215 215 218 218 218 219 220 221  82  15  19  17 194 218
 214 217 216 218 219 219 219 220 220 222  82  22  24  24 201 217
 218 217 219 220 219 217 219 219 220 222  79  29  29  31 204 218
 218 219 218 220 209 112 122 139  99 117 122 130 161 149 219 223
 215 220 220 221 197  19  17  12  18  13 182 226 228 228 226 225
 218 221 221 220 192  25  27  24  26  18 156 227 228 228 227 225
 221 222 223 223 209  24  27  25  25  20 163 229 230 229 228 228
 223 224 225 224 218  41  28  27  27  20 173 229 230 229 230 228
 226 224 226 224 216  47  35  36  36  30 176 230 232 231 230 227
 222 226 226 228 225 189 176 206 195 177 216 230 233 233 231 228
 224 228 227 228 229 231 231 232 232 231 231 233 234 234 232 229
 225 228 228 230 231 231 230 232 232 231 232 234 233 234 233 228
 229 230 230 231 231 231 231 231 233 233 233 232 234 234 234 228
 211 208 193 204 212 204 199 210 220 204 213 220 219 211 220 225
 206 213 213 214 215 216 217 219 219 218 214 212 212 214 218 217
 207 213 216 215 217 217 217 219 218 217 149 113  77  84 186 218
 211 216 216 217 219 219 219 220 220 219  94  15  19  18 183 217
 215 219 217 219 219 220 219 220 221 220  95  23  23  26 180 220
 216 218 219 221 219 217 217 218 215 217  89  32  38  39 187 219
 214 221 219 221 206 104 117 133  95 114 131 142 169 152 215 224
 208 222 221 221 200  26  17  13  16  14 184 227 228 229 226 224
 212 222 222 222 200  32  27  23  25  19 163 227 228 228 227 225
 214 224 223 224 208  29  26  25  25  19 164 228 230 228 227 226
 218 224 225 225 209  50  28  27  26  20 161 230 230 229 230 228
 223 225 227 226 215  57  44  48  47  35 172 230 232 231 229 226
 219 227 227 228 225 195 186 207 196 173 217 230 233 232 230 228
 219 229 228 229 229 232 232 232 233 232 231 232 233 232 230 228
 221 229 229 230 231 231 230 233 232 231 232 235 233 233 233 226
 226 229 229 231 230 231 231 231 233 233 232 232 233 232 234 227
 209 204 183 194 204 200 198 209 215 198 205 213 217 208 216 220

 218 217 218 216 216 225 226 228 230 231 227 228 225 224 229 230
 225 207 208 214 216 225 232 231 232 234 235 235 237 237 239 230
 227 109  28  40  45 146 234 233 235 235 236 237 237 239 240 225
 226  90  25  28  25 155 232 233 234 233 236 237 238 238 238 231
 224 128  15  25  27 127 232 231 233 234 234 236 237 240 238 231
 224 150  77  76  73 131 202 186 191 200 201 221 236 238 239 220
 223 223 226 225 227 133  18  24  26  26  31 165 236 235 239 206
 223 224 225 225 228 118  22  31  30  32  33 188 238 236 238 228
 223 225 226 226 226 168  15  29  31  32  36 208 236 237 237 224
 223 223 224 226 226 143  20  32  32  32  33 183 237 235 237 216
 223 222 225 226 227 117  20  29  25  39  33 197 238 237 237 218
 222 223 224 225 227 209 199 195 211 218 213 230 235 235 235 218
 219 221 222 224 227 226 227 227 229 229 230 232 234 235 236 208
 217 221 223 222 225 226 227 226 229 231 230 231 233 233 236 196
 217 220 221 224 223 224 226 226 228 228 229 232 233 232 235 216
 216 219 220 223 222 223 226 228 228 228 233 228 230 232 234 229
 218 218 218 217 218 223 225 225 228 228 227 228 229 228 228 225
 219 199 194 201 204 219 226 227 228 230 230 231 232 233 234 220
 217 100  17  24  31 149 228 228 229 229 231 233 234 234 234 211
 214  85  19  24  29 161 228 228 230 230 232 233 234 233 234 219
 214 119  15  22  29 130 226 227 229 229 230 230 233 234 232 220
 216 147  82  82  79 122 182 156 163 173 176 216 231 232 233 213
 218 218 221 222 222 117  13  18  20  20  30 177 231 231 233 204
 217 217 220 220 220  99  18  26  25  27  36 195 232 232 233 220
 217 218 219 220 219 139  12  24  25  27  36 206 232 232 231 210
 216 216 218 219 219 122  17  27  27  28  35 176 231 230 231 199
 215 216 218 219 217 112  19  25  24  41  47 189 231 231 231 204
 214 216 218 219 219 209 197 192 209 218 216 225 229 231 231 212
 213 213 215 218 220 220 221 220 223 224 224 228 228 230 231 204
 212 213 215 216 219 218 220 221 223 225 226 226 227 228 230 193
 210 212 215 217 217 219 220 221 222 224 224 226 228 228 230 208
 208 209 213 214 218 218 215 218 221 223 226 222 224 225 229 211
 217 218 217 220 219 224 224 225 226 228 226 228 228 226 227 220
 218 186 183 180 187 215 226 227 227 230 229 230 230 233 234 216
 214  84  18  26  39 152 229 228 228 229 231 232 232 233 232 208
 212  77  19  23  38 169 228 228 230 230 232 233 233 233 233 217
 212 113  15  23  32 142 227 227 228 230 230 230 232 235 232 213
 214 149  94  95  89 131 184 163 164 161 172 217 231 232 232 205
 218 217 219 220 217 114  14  19  19  20  35 173 232 231 233 198
 219 218 220 221 215  95  16  25  25  26  47 196 233 232 233 215
 219 219 220 220 218 133  13  23  25  27  48 207 232 233 231 209
 217 217 219 219 217 117  17  27  26  28  44 186 232 230 231 198
 216 217 219 220 217 104  26  32  29  50  57 195 232 231 231 200
 215 217 219 219 219 206 200 200 208 209 215 225 229 231 230 204
 214 215 217 219 221 221 221 222 224 225 226 228 229 230 231 194
 213 216 216 217 219 219 221 222 223 225 227 227 228 229 229 183
 213 213 216 219 218 221 222 222 224 224 225 227 229 229 229 204
 206 207 211 215 216 214 208 212 214 218 223 219 219 221 226 209

