 255 255 255 255 255 255 255 253 250 251 255 255 254 255 254 248
 255 253 254 254 254 255 255 255 255 255 254 253 252 252 253 253
 255 249 244 248 250 235 242 244 245 251 255 254 251 250 251 251
 255 255 237 200 166 166 176 167 169 169 222 252 253 253 254 251
 252 253 242 206 100  56  49  71  73  75 192 247 254 255 254 252
 255 253 254 248 190  89  40  45  50  44  64 155 254 253 255 255
 255 252 254 254 244 153  76  39  42  44  44  75 162 248 255 255
 254 253 251 250 253 250 139  76  42  41  45  49  81 175 253 255
 252 252 253 250 254 254 217 102  60  43  46  44  11  85 239 255
 253 254 253 254 249 217 171  74  57  46  39  20  31 136 218 255
 254 254 255 252 230 209 134  72  44  41  24  34 137 226 255 255
 255 254 253 231 189 119  76  48  32  10  35 149 221 248 255 255
 255 255 235 210 154 108  41  30  22  38 116 227 255 255 254 254
 254 254 232 244 210 198 156 135 115 184 238 255 255 253 253 252
 253 254 253 253 251 243 255 255 255 255 255 255 252 253 254 253
 255 255 255 255 255 255 255 255 255 255 255 255 255 254 254 254
 215 214 237 228 236 233 228 218 211 220 228 227 226 218 210 200
 237 241 247 250 251 252 252 252 249 249 245 242 243 245 245 242
 234 230 225 222 233 204 214 224 228 239 245 247 244 244 245 245
 232 223 199 136 111 119 126  98 107 121 168 234 241 243 244 245
 235 245 220 157  74  38  38  37  36  41  91 171 228 243 247 248
 234 244 251 234 160  63  34  30  26  21  25  76 189 232 248 251
 236 243 247 246 231 147  70  28  25  23  17  24  76 186 233 245
 235 240 243 243 247 232 121  66  30  24  23  23  23  96 206 241
 228 240 245 245 249 231 180 112  64  31  25  21   0  35 169 216
 231 241 245 249 235 189 150 102  71  39  20   4  11  95 165 217
 233 244 251 242 207 160 105  70  41  32  11  13  92 173 218 232
 233 245 244 207 133  98  69  46  25   4  15 100 159 207 228 238
 234 235 199 162 101  80  30  10   1   4  64 157 205 229 237 238
 231 230 198 168 139 135  97  77  60 116 175 203 227 231 239 242
 225 239 241 232 225 209 227 220 223 220 219 226 236 238 240 244
 228 240 246 248 244 243 245 243 243 248 247 245 245 243 246 250
 190 193 216 206 214 209 202 189 179 190 203 204 205 197 194 180
 209 218 228 231 234 234 239 239 238 236 231 227 225 224 227 228
 202 203 204 194 217 193 206 215 219 228 234 234 231 230 231 232
 192 192 166  76  80 115 126  92  93 109 158 224 230 230 230 230
 197 220 196 112  54  35  39  46  41  39  76 155 212 224 229 233
 184 217 235 211 134  40  37  36  34  23  22  65 163 211 230 235
 193 211 222 223 209 123  63  33  33  24  16  25  78 167 212 232
 199 211 227 233 237 213 113  76  43  29  23  19  17  79 186 223
 195 215 226 233 243 222 170 117  78  40  28  19   0  17 128 180
 187 214 226 237 229 188 162 125  89  51  21   2   3  62 116 172
 179 211 235 231 203 157 110  85  53  38   8   2  50 114 167 198
 192 217 229 206 139 114  85  61  35   2   4  61 109 152 190 210
 200 207 168 127 107  86  37  14   0   0  39 111 166 196 208 222
 204 202 163 101 105 104  73  54  39  63 116 158 180 192 215 224
 186 216 224 213 202 183 216 204 204 195 190 195 208 216 224 231
 203 220 234 240 237 237 236 229 227 234 226 229 230 232 234 240

 248 253 251 251 252 255 255 255 255 255 255 255 254 252 253 254
 254 253 251 254 254 255 255 253 239 218 255 255 254 253 254 254
 255 252 250 253 255 253 248 175  85 136 226 248 255 253 253 254
 254 252 251 253 254 254 162  81  11  31 137 221 255 255 252 255
 255 253 254 252 247 155  75  49  44  20  34 149 227 255 255 255
 255 254 255 222 192  64  44  45  46  39  24  35 116 238 255 255
 251 255 251 169  75  44  44  41  43  46  41  10  38 184 255 255
 250 255 245 169  73  50  42  42  60  57  44  32  22 115 255 255
 253 255 244 167  71  45  39  76 102  74  72  48  30 135 255 255
 255 255 242 176  49  40  76 139 217 171 134  76  41 156 255 255
 255 255 235 166  56  89 153 250 254 217 209 119 108 198 243 255
 255 254 250 166 100 190 244 253 254 249 230 189 154 210 251 255
 255 254 248 200 206 248 254 250 250 254 252 231 210 244 253 255
 255 254 244 237 242 254 254 251 253 253 255 253 235 232 253 255
 255 253 249 255 253 253 252 253 252 254 254 254 255 254 254 255
 255 255 255 255 252 255 255 254 252 253 254 255 255 254 253 255
 200 242 245 245 248 251 245 241 216 217 232 238 238 242 244 250
 210 245 245 244 247 248 233 206 169 165 218 228 237 239 240 246
 218 245 244 243 243 232 186  96  35  95 173 207 229 231 238 243
 226 243 244 241 228 189  76  23   0  11  92 159 205 227 236 245
 227 242 247 234 171  76  24  23  21   4  13 100 157 203 226 245
 228 245 245 168  91  25  17  23  25  20  11  15  64 175 219 247
 220 249 239 121  41  21  23  24  31  39  32   4   4 116 220 248
 211 249 228 107  36  26  25  30  64  71  41  25   1  60 223 243
 218 252 224  98  37  30  28  66 112 102  70  46  10  77 220 243
 228 252 214 126  38  34  70 121 180 150 105  69  30  97 227 245
 233 252 204 119  38  63 147 232 231 189 160  98  80 135 209 243
 236 251 233 111  74 160 231 247 249 235 207 133 101 139 225 244
 228 250 222 136 157 234 246 243 245 249 242 207 162 168 232 248
 237 247 225 199 220 251 247 243 245 245 251 244 199 198 241 246
 214 241 230 223 245 244 243 240 240 241 244 245 235 230 239 240
 215 237 234 232 235 234 236 235 228 231 233 233 234 231 225 228
 180 228 232 230 233 235 232 223 180 172 198 210 222 224 231 240
 194 227 231 230 229 230 212 186 128 116 167 190 208 215 224 234
 197 224 230 230 224 211 167  79  17  62 114 152 196 192 216 232
 205 225 231 230 212 163  78  17   0   3  50 109 166 180 208 230
 204 227 234 224 155  65  25  19  19   2   2  61 111 158 195 229
 203 231 234 158  76  22  16  23  28  21   8   4  39 116 190 226
 190 236 228 109  39  23  24  29  40  51  38   2   0  63 195 234
 179 238 219  93  41  34  33  43  78  89  53  35   0  39 204 227
 189 239 215  92  46  36  33  76 117 125  85  61  14  54 204 229
 202 239 206 126  39  37  63 113 170 162 110  85  37  73 216 236
 209 234 193 115  35  40 123 213 222 188 157 114  86 104 183 237
 214 234 217  80  54 134 209 237 243 229 203 139 107 105 202 237
 206 231 194  76 112 211 223 233 233 237 231 206 127 101 213 240
 216 228 204 166 196 235 222 227 226 226 235 229 168 163 224 234
 193 218 203 192 220 217 211 211 215 214 211 217 207 202 216 220
 190 209 202 192 197 184 193 199 195 187 179 192 200 204 186 203

 254 254 254 255 255 255 255 255 255 255 255 255 255 255 255 255
 253 254 253 252 255 255 255 255 255 255 243 251 253 253 254 253
 252 253 253 255 255 238 184 115 135 156 198 210 244 232 254 254
 254 254 255 255 227 116  38  22  30  41 108 154 210 235 255 255
 255 255 248 221 149  35  10  32  48  76 119 189 231 253 254 255
 255 255 226 137  34  24  41  44  72 134 209 230 252 255 254 254
 255 218 136  31  20  39  46  57  74 171 217 249 254 253 254 253
 255 239  85  11  44  46  43  60 102 217 254 254 250 253 252 252
 255 253 175  81  49  45  41  42  76 139 250 253 250 251 253 254
 255 255 248 162  75  44  44  42  39  76 153 244 254 254 252 255
 255 255 253 254 155  64  44  50  45  40  89 190 248 254 253 255
 252 254 255 254 247 192  75  73  71  49  56 100 206 242 253 252
 251 254 253 253 252 222 169 169 167 176 166 166 200 237 255 255
 251 251 250 251 254 255 251 245 244 242 235 250 248 244 249 255
 253 253 252 252 253 254 255 255 255 255 255 254 254 254 253 255
 248 254 255 254 255 255 251 250 253 255 255 255 255 255 255 255
 250 246 243 245 245 247 248 243 243 245 243 244 248 246 240 228
 244 240 238 236 226 219 220 223 220 227 209 225 232 241 239 225
 242 239 231 227 203 175 116  60  77  97 135 139 168 198 230 231
 238 237 229 205 157  64   4   1  10  30  80 101 162 199 235 234
 238 228 207 159 100  15   4  25  46  69  98 133 207 244 245 233
 232 218 173  92  13  11  32  41  70 105 160 207 242 251 244 233
 217 165  95  11   4  20  39  71 102 150 189 235 249 245 241 231
 216 169  35   0  21  25  31  64 112 180 231 249 245 245 240 228
 241 206  96  23  23  23  24  30  66 121 232 247 243 243 240 235
 245 233 186  76  24  17  23  25  28  70 147 231 246 247 243 236
 251 248 232 189  76  25  21  26  30  34  63 160 234 251 244 234
 248 247 243 228 171  91  41  36  37  38  38  74 157 220 245 235
 245 244 243 241 234 168 121 107  98 126 119 111 136 199 223 232
 245 245 244 244 247 245 239 228 224 214 204 233 222 225 230 234
 242 245 245 243 242 245 249 249 252 252 252 251 250 247 241 237
 200 210 218 226 227 228 220 211 218 228 233 236 228 237 214 215
 240 234 232 230 229 226 234 227 229 236 237 237 240 234 220 203
 231 224 216 208 195 190 195 204 204 216 183 202 213 224 216 186
 224 215 192 180 158 116  63  39  54  73 104 105 101 163 202 204
 222 208 196 166 111  39   0   0  14  37  86 107 127 168 207 200
 210 190 152 109  61   4   2  35  61  85 114 139 206 229 217 192
 198 167 114  50   2   8  38  53  85 110 157 203 231 235 211 179
 172 116  62   3   2  21  51  89 125 162 188 229 237 226 214 187
 180 128  17   0  19  28  40  78 117 170 222 243 233 226 215 195
 223 186  79  17  19  23  29  43  76 113 213 237 233 227 211 199
 232 212 167  78  25  16  24  33  33  63 123 209 223 222 211 193
 235 230 211 163  65  22  23  34  36  37  40 134 211 235 217 184
 233 229 224 212 155  76  39  41  46  39  35  54 112 196 220 197
 230 230 230 230 224 158 109  93  92 126 115  80  76 166 192 192
 232 231 230 231 234 234 228 219 215 206 193 217 194 204 203 202
 228 227 224 225 227 231 236 238 239 239 234 234 231 228 218 209
 180 194 197 205 204 203 190 179 189 202 209 214 206 216 193 190

 255 253 254 255 255 254 253 252 254 255 255 252 255 255 255 255
 255 254 254 255 254 254 254 252 253 252 253 253 255 249 253 255
 255 253 232 235 253 255 253 253 251 254 254 242 237 244 254 255
 255 253 244 210 231 252 254 250 250 254 248 206 200 248 254 255
 255 251 210 154 189 230 249 254 253 244 190 100 166 250 254 255
 255 243 198 108 119 209 217 254 250 153  89  56 166 235 255 255
 255 255 156  41  76 134 171 217 139  76  40  49 176 242 255 255
 255 255 135  30  48  72  74 102  76  39  45  71 167 244 255 253
 255 255 115  22  32  44  57  60  42  42  50  73 169 245 255 250
 255 255 184  38  10  41  46  43  41  44  44  75 169 251 255 251
 255 255 238 116  35  24  39  46  45  44  64 192 222 255 254 255
 255 255 255 227 149  34  20  44  49  75 155 247 252 254 253 255
 255 252 255 255 221 137  31  11  81 162 254 254 253 251 252 254
 254 253 253 255 248 226 136  85 175 248 253 255 253 250 252 255
 254 254 253 254 255 255 218 239 253 255 255 254 254 251 253 254
 254 253 252 254 255 255 255 255 255 255 255 252 251 251 253 248
 228 225 231 234 233 233 231 228 235 236 234 235 232 234 237 215
 240 239 230 235 245 244 241 240 240 243 244 245 223 230 241 214
 246 241 198 199 244 251 245 245 243 247 251 220 199 225 247 237
 248 232 168 162 207 242 249 245 243 246 234 157 136 222 250 228
 244 225 139 101 133 207 235 249 247 231 160  74 111 233 251 236
 243 209 135  80  98 160 189 231 232 147  63  38 119 204 252 233
 245 227  97  30  69 105 150 180 121  70  34  38 126 214 252 228
 243 220  77  10  46  70 102 112  66  28  30  37  98 224 252 218
 243 223  60   1  25  41  71  64  30  25  26  36 107 228 249 211
 248 220 116   4   4  32  39  31  24  23  21  41 121 239 249 220
 247 219 175  64  15  11  20  25  23  17  25  91 168 245 245 228
 245 226 203 157 100  13   4  21  23  24  76 171 234 247 242 227
 245 236 227 205 159  92  11   0  23  76 189 228 241 244 243 226
 243 238 231 229 207 173  95  35  96 186 232 243 243 244 245 218
 246 240 239 237 228 218 165 169 206 233 248 247 244 245 245 210
 250 244 242 238 238 232 217 216 241 245 251 248 245 245 242 200
 203 186 204 200 192 179 187 195 199 193 184 197 192 202 209 190
 220 216 202 207 217 211 214 215 211 211 217 220 192 203 218 193
 234 224 163 168 229 235 226 226 227 222 235 196 166 204 228 216
 240 213 101 127 206 231 237 233 233 223 211 112  76 194 231 206
 237 202 105 107 139 203 229 243 237 209 134  54  80 217 234 214
 237 183 104  86 114 157 188 222 213 123  40  35 115 193 234 209
 236 216  73  37  85 110 162 170 113  63  37  39 126 206 239 202
 229 204  54  14  61  85 125 117  76  33  36  46  92 215 239 189
 227 204  39   0  35  53  89  78  43  33  34  41  93 219 238 179
 234 195  63   0   2  38  51  40  29  24  23  39 109 228 236 190
 226 190 116  39   4   8  21  28  23  16  22  76 158 234 231 203
 229 195 158 111  61   2   2  19  19  25  65 155 224 234 227 204
 230 208 180 166 109  50   3   0  17  78 163 212 230 231 225 205
 232 216 192 196 152 114  62  17  79 167 211 224 230 230 224 197
 234 224 215 208 190 167 116 128 186 212 230 229 230 231 227 194
 240 231 224 222 210 198 172 180 223 232 235 233 230 232 228 180

