 204 212 200 209 210 199 207 210 193 204 200 192 208 203 191 207
 198 219 218 210 211 213 213 211 210 210 210 207 203 204 203 204
 210 220 212  65  29  69 214 215 213 213 210 207 204 205 204 203
 210 216 207  46  19  56 216 212 211 211 208 208 207 205 202 201
 206 214 211  59  18  73 216 212 211 209 207 204 207 203 203 203
 207 212 213  59  23  59 210 211 209 211 207 203 207 205 204 204
 195 212 205  51  24  77 206 188 195 170 187 198 176 184 182 196
 201 211 206  64  24  72 179  30  31  27  30  34  20  25  34 187
 210 212 198  48  22  56 191  31  19  16  17  18  14  14  18 172
 198 210 199  43  20  69 195 100  73  99  95  79 106  85  81 179
 201 208 205  57  17  66 209 206 204 203 202 202 202 200 197 195
 205 209 198  44  19  67 207 206 204 202 202 201 198 199 198 194
 197 207 190  40  17  76 202 203 201 201 202 199 198 198 196 193
 204 208 197  43   9  48 205 203 201 201 201 198 196 195 194 189
 199 205 197 117 129 136 202 200 202 199 196 198 194 192 191 193
 196 205 202 203 202 206 201 203 200 200 201 200 196 195 195 193
 187 199 192 200 200 190 198 199 187 195 195 184 198 193 183 196
 179 208 207 203 203 205 203 202 202 201 200 199 196 196 196 196
 187 205 201  63  27  59 196 202 202 201 200 200 197 196 196 195
 185 204 198  56  20  51 194 200 201 200 199 199 197 195 195 196
 181 202 200  67  18  65 200 200 199 199 199 198 197 195 195 194
 189 201 198  62  20  41 192 199 199 198 198 196 197 196 194 194
 178 200 194  52  21  56 189 181 188 165 177 189 165 178 176 185
 181 200 198  74  24  64 159  42  34  24  25  28  19  25  28 158
 188 197 193  62  21  49 172  42  18  13  15  15  11  13  15 151
 174 197 190  55  18  61 178 103  71  92  88  68  99  80  78 165
 185 197 194  66  18  49 190 193 193 193 192 192 191 189 188 186
 187 196 186  52  18  52 189 193 193 193 193 192 190 189 188 186
 175 195 187  55  14  65 191 191 192 192 192 190 190 186 186 186
 181 194 187  50   8  40 184 190 190 190 189 189 187 186 186 183
 180 193 189 123 124 131 184 188 189 188 188 187 186 185 183 183
 179 193 194 193 193 194 192 192 191 191 191 189 188 188 186 185
 170 197 185 193 192 186 196 195 176 188 186 182 197 186 177 192
 166 203 205 198 204 203 201 201 200 198 199 197 194 194 194 194
 176 203 200  83  35  64 186 200 200 199 199 198 195 194 194 195
 175 201 195  70  21  49 184 198 198 197 199 198 196 192 193 192
 166 198 197  79  19  56 180 197 197 196 199 197 195 192 193 191
 171 199 194  89  21  39 170 196 198 197 195 194 196 193 191 192
 163 198 192  76  25  57 176 176 186 164 176 188 167 175 170 183
 171 198 198  93  28  63 147  53  40  30  34  39  24  28  26 149
 177 196 193  77  26  46 164  49  19  14  13  14  12  13  14 140
 164 195 188  72  20  54 169  98  66  87  87  69  92  74  68 149
 163 194 191  83  19  45 171 190 189 191 191 188 189 185 184 183
 167 194 187  70  19  50 171 190 192 192 190 190 190 187 186 183
 162 194 187  73  17  63 175 188 190 189 189 189 188 185 184 186
 168 191 184  65  12  34 168 188 188 186 189 188 186 184 183 180
 170 191 185 122 118 116 174 188 187 187 185 185 184 183 182 180
 162 191 194 195 193 194 191 192 190 190 190 187 186 187 185 185

 207 204 203 201 203 204 196 187 172 179 195 194 193 189 193 193
 191 203 204 202 203 204 182  34  18  81 197 198 196 194 191 195
 203 204 205 205 203 205 184  25  14  85 200 199 198 195 192 195
 208 203 204 207 207 207 176  20  14 106 202 198 198 196 194 196
 192 207 207 208 204 203 198  34  18  79 202 201 199 198 198 200
 200 210 210 208 207 207 187  30  17  95 202 202 202 201 196 201
 204 210 213 211 209 211 170  27  16  99 203 202 201 201 199 200
 193 210 213 211 211 209 195  31  19  73 204 204 201 201 202 200
 210 211 215 212 212 211 188  30  31 100 206 206 203 203 200 203
 207 213 214 216 216 210 206 179 191 195 209 207 202 205 202 201
 199 213  69  56  73  59  77  72  56  69  66  67  76  48 136 206
 210 211  29  19  18  23  24  24  22  20  17  19  17   9 129 202
 209 210  65  46  59  59  51  64  48  43  57  44  40  43 117 203
 200 218 212 207 211 213 205 206 198 199 205 198 190 197 197 202
 212 219 220 216 214 212 212 211 212 210 208 209 207 208 205 205
 204 198 210 210 206 207 195 201 210 198 201 205 197 204 199 196
 196 196 195 196 194 194 185 158 151 165 186 186 186 183 183 185
 183 196 196 195 195 194 176  28  15  78 188 188 186 186 183 186
 193 196 196 195 195 196 178  25  13  80 189 189 186 186 185 188
 198 196 197 197 197 197 165  19  11  99 191 190 190 187 186 188
 184 199 200 199 198 196 189  28  15  68 192 192 190 189 187 189
 195 200 200 199 199 198 177  25  15  88 192 193 192 189 188 191
 195 201 201 200 199 198 165  24  13  92 193 193 192 190 188 191
 187 202 202 201 199 199 188  34  18  71 193 193 192 190 189 191
 199 202 202 200 200 199 181  42  42 103 193 193 191 190 188 192
 198 203 196 194 200 192 189 159 172 178 190 189 191 184 184 192
 190 205  59  51  65  41  56  64  49  61  49  52  65  40 131 194
 200 203  27  20  18  20  21  24  21  18  18  18  14   8 124 193
 200 203  63  56  67  62  52  74  62  55  66  52  55  50 123 193
 192 207 201 198 200 198 194 198 193 190 194 186 187 187 189 194
 199 208 205 204 202 201 200 200 197 197 197 196 195 194 193 193
 187 179 187 185 181 189 178 181 188 174 185 187 175 181 180 179
 192 194 195 192 191 192 183 149 140 149 183 183 186 180 180 185
 177 194 194 193 193 191 170  26  14  68 184 186 184 183 182 185
 186 194 194 192 192 193 175  28  13  74 185 187 185 184 183 187
 197 194 195 196 195 196 167  24  12  92 189 190 188 186 184 186
 182 197 198 198 197 194 188  39  14  69 188 190 189 188 185 187
 186 199 199 199 199 195 176  34  13  87 191 190 189 189 185 190
 188 198 199 197 196 197 164  30  14  87 191 192 189 186 187 190
 176 200 200 198 197 198 186  40  19  66 189 192 190 188 187 190
 195 201 200 198 197 196 176  53  49  98 190 190 188 188 188 192
 196 201 186 184 180 170 176 147 164 169 171 171 175 168 174 191
 186 203  64  49  56  39  57  63  46  54  45  50  63  34 116 194
 192 204  35  21  19  21  25  28  26  20  19  19  17  12 118 193
 193 198  83  70  79  89  76  93  77  72  83  70  73  65 122 195
 185 205 200 195 197 194 192 198 193 188 191 187 187 184 185 194
 197 203 203 201 198 199 198 198 196 195 194 194 194 191 191 191
 170 166 176 175 166 171 163 171 177 164 163 167 162 168 170 162

 193 195 195 196 200 201 200 200 203 201 206 202 203 202 205 196
 193 191 192 194 198 196 199 202 200 202 136 129 117 197 205 199
 189 194 195 196 198 201 201 201 203 205  48   9  43 197 208 204
 193 196 198 198 199 202 201 201 203 202  76  17  40 190 207 197
 194 198 199 198 201 202 202 204 206 207  67  19  44 198 209 205
 195 197 200 202 202 202 203 204 206 209  66  17  57 205 208 201
 179  81  85 106  79  95  99  73 100 195  69  20  43 199 210 198
 172  18  14  14  18  17  16  19  31 191  56  22  48 198 212 210
 187  34  25  20  34  30  27  31  30 179  72  24  64 206 211 201
 196 182 184 176 198 187 170 195 188 206  77  24  51 205 212 195
 204 204 205 207 203 207 211 209 211 210  59  23  59 213 212 207
 203 203 203 207 204 207 209 211 212 216  73  18  59 211 214 206
 201 202 205 207 208 208 211 211 212 216  56  19  46 207 216 210
 203 204 205 204 207 210 213 213 215 214  69  29  65 212 220 210
 204 203 204 203 207 210 210 210 211 213 213 211 210 218 219 198
 207 191 203 208 192 200 204 193 210 207 199 210 209 200 212 204
 185 186 188 188 189 191 191 191 192 192 194 193 193 194 193 179
 183 183 185 186 187 188 188 189 188 184 131 124 123 189 193 180
 183 186 186 187 189 189 190 190 190 184  40   8  50 187 194 181
 186 186 186 190 190 192 192 192 191 191  65  14  55 187 195 175
 186 188 189 190 192 193 193 193 193 189  52  18  52 186 196 187
 186 188 189 191 192 192 193 193 193 190  49  18  66 194 197 185
 165  78  80  99  68  88  92  71 103 178  61  18  55 190 197 174
 151  15  13  11  15  15  13  18  42 172  49  21  62 193 197 188
 158  28  25  19  28  25  24  34  42 159  64  24  74 198 200 181
 185 176 178 165 189 177 165 188 181 189  56  21  52 194 200 178
 194 194 196 197 196 198 198 199 199 192  41  20  62 198 201 189
 194 195 195 197 198 199 199 199 200 200  65  18  67 200 202 181
 196 195 195 197 199 199 200 201 200 194  51  20  56 198 204 185
 195 196 196 197 200 200 201 202 202 196  59  27  63 201 205 187
 196 196 196 196 199 200 201 202 202 203 205 203 203 207 208 179
 196 183 193 198 184 195 195 187 199 198 190 200 200 192 199 187
 185 185 187 186 187 190 190 190 192 191 194 193 195 194 191 162
 180 182 183 184 185 185 187 187 188 174 116 118 122 185 191 170
 180 183 184 186 188 189 186 188 188 168  34  12  65 184 191 168
 186 184 185 188 189 189 189 190 188 175  63  17  73 187 194 162
 183 186 187 190 190 190 192 192 190 171  50  19  70 187 194 167
 183 184 185 189 188 191 191 189 190 171  45  19  83 191 194 163
 149  68  74  92  69  87  87  66  98 169  54  20  72 188 195 164
 140  14  13  12  14  13  14  19  49 164  46  26  77 193 196 177
 149  26  28  24  39  34  30  40  53 147  63  28  93 198 198 171
 183 170 175 167 188 176 164 186 176 176  57  25  76 192 198 163
 192 191 193 196 194 195 197 198 196 170  39  21  89 194 199 171
 191 193 192 195 197 199 196 197 197 180  56  19  79 197 198 166
 192 193 192 196 198 199 197 198 198 184  49  21  70 195 201 175
 195 194 194 195 198 199 199 200 200 186  64  35  83 200 203 176
 194 194 194 194 197 199 198 200 201 201 203 204 198 205 203 166
 192 177 186 197 182 186 188 176 195 196 186 192 193 185 197 170

 196 199 204 197 205 201 198 210 201 195 207 206 210 210 198 204
 205 205 208 207 209 208 210 212 211 212 212 214 216 220 219 212
 202 197 197 190 198 205 199 198 206 205 213 211 207 212 218 200
 203 117  43  40  44  57  43  48  64  51  59  59  46  65 210 209
 202 129   9  17  19  17  20  22  24  24  23  18  19  29 211 210
 206 136  48  76  67  66  69  56  72  77  59  73  56  69 213 199
 201 202 205 202 207 209 195 191 179 206 210 216 216 214 213 207
 203 200 203 203 206 206 100  31  30 188 211 212 212 215 211 210
 200 202 201 201 204 204  73  19  31 195 209 211 211 213 210 193
 200 199 201 201 202 203  99  16  27 170 211 209 211 213 210 204
 201 196 201 202 202 202  95  17  30 187 207 207 208 210 210 200
 200 198 198 199 201 202  79  18  34 198 203 204 208 207 207 192
 196 194 196 198 198 202 106  14  20 176 207 207 207 204 203 208
 195 192 195 198 199 200  85  14  25 184 205 203 205 205 204 203
 195 191 194 196 198 197  81  18  34 182 204 203 202 204 203 191
 193 193 189 193 194 195 179 172 187 196 204 203 201 203 204 207
 179 180 181 175 187 185 174 188 181 178 189 181 185 187 179 187
 193 193 194 195 196 197 197 197 200 200 201 202 204 205 208 199
 194 189 187 187 186 194 190 193 198 194 198 200 198 201 207 192
 193 123  50  55  52  66  55  62  74  52  62  67  56  63 203 200
 193 124   8  14  18  18  18  21  24  21  20  18  20  27 203 200
 194 131  40  65  52  49  61  49  64  56  41  65  51  59 205 190
 192 184 184 191 189 190 178 172 159 189 192 200 194 196 203 198
 192 188 190 191 193 193 103  42  42 181 199 200 200 202 202 199
 191 189 190 192 193 193  71  18  34 188 199 199 201 202 202 187
 191 188 190 192 193 193  92  13  24 165 198 199 200 201 201 195
 191 188 189 192 193 192  88  15  25 177 198 199 199 200 200 195
 189 187 189 190 192 192  68  15  28 189 196 198 199 200 199 184
 188 186 187 190 190 191  99  11  19 165 197 197 197 197 196 198
 188 185 186 186 189 189  80  13  25 178 196 195 195 196 196 193
 186 183 186 186 188 188  78  15  28 176 194 195 195 196 196 183
 185 183 183 186 186 186 165 151 158 185 194 194 196 195 196 196
 162 170 168 162 167 163 164 177 171 163 171 166 175 176 166 170
 191 191 191 194 194 194 195 196 198 198 199 198 201 203 203 197
 194 185 184 187 187 191 188 193 198 192 194 197 195 200 205 185
 195 122  65  73  70  83  72  77  93  76  89  79  70  83 198 193
 193 118  12  17  19  19  20  26  28  25  21  19  21  35 204 192
 194 116  34  63  50  45  54  46  63  57  39  56  49  64 203 186
 191 174 168 175 171 171 169 164 147 176 170 180 184 186 201 196
 192 188 188 188 190 190  98  49  53 176 196 197 198 200 201 195
 190 187 188 190 192 189  66  19  40 186 198 197 198 200 200 176
 190 187 186 189 192 191  87  14  30 164 197 196 197 199 198 188
 190 185 189 189 190 191  87  13  34 176 195 199 199 199 199 186
 187 185 188 189 190 188  69  14  39 188 194 197 198 198 197 182
 186 184 186 188 190 189  92  12  24 167 196 195 196 195 194 197
 187 183 184 185 187 185  74  13  28 175 193 192 192 194 194 186
 185 182 183 184 186 184  68  14  26 170 191 193 193 194 194 177
 185 180 180 186 183 183 149 140 149 183 192 191 192 195 194 192

