 252 245 236 243 241 239 244 244 237 243 239 240 242 237 233 242
 240 246 246 246 246 246 246 247 244 245 246 245 244 243 244 247
 242 245 244 214 232 233 217 231 245 245 245 243 244 243 242 245
 245 246 238  69  50  60  61  50 239 245 243 243 243 242 241 244
 240 245 230  51  44  43  43  69 241 244 241 243 242 240 238 242
 247 246 232  62  45  41  40  47 193 248 245 243 242 240 239 242
 241 244 240  60  43  43  40  39  60 194 247 245 241 239 238 240
 240 245 230  80  70  72  35  39  40  55 191 249 243 240 237 237
 244 245 243 244 243 242 171  37  34  39  45 190 245 241 238 237
 235 246 243 243 243 241 243 180  30  35  38  40 188 248 238 237
 243 245 243 242 241 239 241 242 176  30  32  35  38 188 241 236
 237 244 243 242 241 241 238 239 238 182  29  28  31  28 165 241
 236 244 243 241 242 240 238 239 238 240 182  35  21  21 183 238
 242 243 241 241 240 239 236 236 237 236 236 176  39 169 237 237
 223 241 240 239 239 236 236 236 236 236 234 236 213 234 234 235
 240 244 243 240 238 239 237 237 236 235 238 236 234 234 233 232
 222 225 221 229 224 222 229 225 218 228 224 219 225 218 217 225
 221 234 234 235 235 236 235 235 233 233 234 233 233 231 230 233
 229 235 231 201 220 225 207 220 232 234 233 232 231 231 230 231
 230 234 224  69  50  59  51  53 222 231 231 231 231 230 228 231
 219 234 222  46  35  34  34  52 218 230 229 229 230 229 226 228
 225 233 217  55  35  34  32  26 157 233 231 229 228 229 226 228
 220 234 229  57  31  30  30  31  46 163 231 229 228 225 225 228
 222 233 225  86  56  56  27  31  33  37 157 230 227 225 225 225
 224 230 233 228 223 220 162  34  29  29  32 165 228 226 224 223
 210 232 231 230 230 227 227 166  27  27  26  29 156 229 224 222
 217 230 230 228 229 226 226 226 173  27  26  26  25 153 221 221
 211 229 229 228 226 226 224 225 223 172  27  23  24  21 142 222
 214 228 227 227 224 226 225 225 224 224 169  31  18  23 159 212
 222 228 227 227 225 224 223 222 222 222 223 176  45 146 207 218
 201 225 226 225 224 222 222 221 222 221 220 219 198 210 215 217
 211 227 227 225 223 222 222 221 222 221 222 222 220 218 218 216
 209 213 206 217 216 213 220 210 204 218 212 212 217 203 203 211
 199 229 230 231 230 232 232 231 228 228 228 227 228 226 225 227
 205 229 227 197 212 215 200 214 228 228 228 226 226 226 225 225
 201 229 218  82  52  62  62  57 206 225 226 225 225 225 224 225
 205 231 213  66  34  29  29  49 193 222 224 224 224 224 223 223
 209 228 202  72  31  29  28  26 154 225 225 225 223 222 222 222
 199 230 217  64  30  28  29  26  45 160 226 224 223 220 222 223
 201 228 219  81  54  52  21  25  29  38 155 225 222 221 221 220
 203 228 230 218 214 205 137  22  24  24  30 162 224 221 220 218
 197 229 228 227 227 222 218 148  20  23  25  29 155 223 219 216
 206 227 224 224 223 221 222 216 150  15  19  25  26 149 217 216
 203 224 224 224 224 222 221 221 214 149  16  19  22  23 136 218
 195 224 222 222 221 220 221 221 220 216 152  22  14  16 138 200
 196 222 224 223 220 221 219 219 219 217 212 149  33 119 185 208
 182 220 221 220 220 218 217 217 217 216 215 213 177 192 205 211
 199 223 222 220 220 218 216 217 216 216 216 217 216 211 214 211

 242 247 245 244 242 242 240 237 237 237 236 241 238 237 235 232
 233 244 242 241 238 239 238 237 238 238 241 165 183 237 234 233
 237 243 243 242 240 240 239 240 241 248 188  28  21 169 234 234
 242 244 244 243 242 242 241 243 245 188  38  31  21  39 213 234
 240 245 243 243 243 243 245 249 190  40  35  28  35 176 236 236
 239 246 245 243 241 245 247 191  45  38  32  29 182 236 234 238
 243 245 245 245 244 248 194  55  39  35  30 182 240 236 236 235
 237 244 245 239 241 193  60  40  34  30 176 238 238 237 236 236
 244 247 231  50  69  47  39  39  37 180 242 239 239 236 236 237
 244 246 217  61  43  40  40  35 171 243 241 238 238 236 236 237
 239 246 233  60  43  41  43  72 242 241 239 241 240 239 236 239
 241 246 232  50  44  45  43  70 243 243 241 241 242 240 239 238
 243 246 214  69  51  62  60  80 244 243 242 242 241 241 239 240
 236 246 244 238 230 232 240 230 243 243 243 243 243 241 240 243
 245 246 245 246 245 246 244 245 245 246 245 244 244 243 241 244
 252 240 242 245 240 247 241 240 244 235 243 237 236 242 223 240
 225 233 231 231 228 228 228 225 223 222 221 222 212 218 217 216
 217 230 230 228 226 226 225 225 224 224 221 142 159 207 215 218
 218 231 231 230 229 229 225 225 226 229 153  21  23 146 210 218
 225 233 231 231 230 228 228 227 228 156  25  24  18  45 198 220
 219 233 232 231 229 229 229 230 165  29  26  23  31 176 219 222
 224 234 233 231 229 231 231 157  32  26  26  27 169 223 220 222
 228 233 234 231 230 233 163  37  29  27  27 172 224 222 221 221
 218 233 232 222 218 157  46  33  29  27 173 223 224 222 222 222
 225 235 220  53  52  26  31  31  34 166 226 225 225 222 221 221
 229 235 207  51  34  32  30  27 162 227 226 224 225 223 222 222
 222 236 225  59  34  34  30  56 220 227 226 226 226 224 222 222
 224 235 220  50  35  35  31  56 223 230 229 226 224 225 224 223
 229 235 201  69  46  55  57  86 228 230 228 228 227 227 225 225
 221 234 231 224 222 217 229 225 233 231 230 229 227 227 226 227
 225 234 235 234 234 233 234 233 230 232 230 229 228 228 225 227
 222 221 229 230 219 225 220 222 224 210 217 211 214 222 201 211
 211 227 225 225 223 222 223 220 218 216 216 218 200 208 211 211
 203 225 225 224 223 222 222 221 220 219 217 136 138 185 205 214
 203 226 226 225 224 222 220 221 221 223 149  23  16 119 192 211
 217 228 226 225 224 223 223 222 224 155  26  22  14  33 177 216
 212 227 226 225 224 225 224 225 162  29  25  19  22 149 213 217
 212 228 228 226 224 225 226 155  30  25  19  16 152 212 215 216
 218 228 228 225 222 225 160  38  24  23  15 149 216 217 216 216
 204 228 228 206 193 154  45  29  24  20 150 214 220 219 217 216
 210 231 214  57  49  26  26  25  22 148 216 221 221 219 217 217
 220 232 200  62  29  28  29  21 137 218 222 221 221 219 217 216
 213 232 215  62  29  29  28  52 205 222 221 222 220 221 218 218
 216 230 212  52  34  31  30  54 214 227 223 224 221 220 220 220
 217 231 197  82  66  72  64  81 218 227 224 224 222 223 220 220
 206 230 227 218 213 202 217 219 230 228 224 224 222 224 221 222
 213 229 229 229 231 228 230 228 228 229 227 224 224 222 220 223
 209 199 205 201 205 209 199 201 203 197 206 203 195 196 182 199

 232 233 234 234 236 238 235 236 237 237 239 238 240 243 244 240
 235 234 234 213 236 234 236 236 236 236 236 239 239 240 241 223
 237 237 169  39 176 236 236 237 236 236 239 240 241 241 243 242
 238 183  21  21  35 182 240 238 239 238 240 242 241 243 244 236
 241 165  28  31  28  29 182 238 239 238 241 241 242 243 244 237
 236 241 188  38  35  32  30 176 242 241 239 241 242 243 245 243
 237 238 248 188  40  38  35  30 180 243 241 243 243 243 246 235
 237 238 241 245 190  45  39  34  37 171 242 243 244 243 245 244
 237 237 240 243 249 191  55  40  39  35  72  70  80 230 245 240
 240 238 239 241 245 247 194  60  39  40  43  43  60 240 244 241
 242 239 240 242 243 245 248 193  47  40  41  45  62 232 246 247
 242 238 240 242 243 241 244 241  69  43  43  44  51 230 245 240
 244 241 242 243 243 243 245 239  50  61  60  50  69 238 246 245
 245 242 243 244 243 245 245 245 231 217 233 232 214 244 245 242
 247 244 243 244 245 246 245 244 247 246 246 246 246 246 246 240
 242 233 237 242 240 239 243 237 244 244 239 241 243 236 245 252
 216 218 218 220 222 222 221 222 221 222 222 223 225 227 227 211
 217 215 210 198 219 220 221 222 221 222 222 224 225 226 225 201
 218 207 146  45 176 223 222 222 222 223 224 225 227 227 228 222
 212 159  23  18  31 169 224 224 225 225 226 224 227 227 228 214
 222 142  21  24  23  27 172 223 225 224 226 226 228 229 229 211
 221 221 153  25  26  26  27 173 226 226 226 229 228 230 230 217
 222 224 229 156  29  26  27  27 166 227 227 230 230 231 232 210
 223 224 226 228 165  32  29  29  34 162 220 223 228 233 230 224
 225 225 225 227 230 157  37  33  31  27  56  56  86 225 233 222
 228 225 225 228 229 231 163  46  31  30  30  31  57 229 234 220
 228 226 229 228 229 231 233 157  26  32  34  35  55 217 233 225
 228 226 229 230 229 229 230 218  52  34  34  35  46 222 234 219
 231 228 230 231 231 231 231 222  53  51  59  50  69 224 234 230
 231 230 231 231 232 233 234 232 220 207 225 220 201 231 235 229
 233 230 231 233 233 234 233 233 235 235 236 235 235 234 234 221
 225 217 218 225 219 224 228 218 225 229 222 224 229 221 225 222
 211 214 211 216 217 216 216 216 217 216 218 220 220 222 223 199
 211 205 192 177 213 215 216 217 217 217 218 220 220 221 220 182
 208 185 119  33 149 212 217 219 219 219 221 220 223 224 222 196
 200 138  16  14  22 152 216 220 221 221 220 221 222 222 224 195
 218 136  23  22  19  16 149 214 221 221 222 224 224 224 224 203
 216 217 149  26  25  19  15 150 216 222 221 223 224 224 227 206
 216 219 223 155  29  25  23  20 148 218 222 227 227 228 229 197
 218 220 221 224 162  30  24  24  22 137 205 214 218 230 228 203
 220 221 221 222 225 155  38  29  25  21  52  54  81 219 228 201
 223 222 220 223 224 226 160  45  26  29  28  30  64 217 230 199
 222 222 222 223 225 225 225 154  26  28  29  31  72 202 228 209
 223 223 224 224 224 224 222 193  49  29  29  34  66 213 231 205
 225 224 225 225 225 226 225 206  57  62  62  52  82 218 229 201
 225 225 226 226 226 228 228 228 214 200 215 212 197 227 229 205
 227 225 226 228 227 228 228 228 231 232 232 230 231 230 229 199
 211 203 203 217 212 212 218 204 210 220 213 216 217 206 213 209

 240 223 242 236 237 243 235 244 240 241 247 240 245 242 240 252
 244 241 243 244 244 245 246 245 245 244 246 245 246 245 246 245
 243 240 241 243 243 243 243 243 230 240 232 230 238 244 246 236
 240 239 241 241 242 242 243 244  80  60  62  51  69 214 246 243
 238 239 240 242 241 241 243 243  70  43  45  44  50 232 246 241
 239 236 239 240 241 239 241 242  72  43  41  43  60 233 246 239
 237 236 236 238 238 241 243 171  35  40  40  43  61 217 246 244
 237 236 236 239 239 242 180  37  39  39  47  69  50 231 247 244
 236 236 237 238 238 176  30  34  40  60 193 241 239 245 244 237
 235 236 236 240 182  30  35  39  55 194 248 244 245 245 245 243
 238 234 236 182  29  32  38  45 191 247 245 241 243 245 246 239
 236 236 176  35  28  35  40 190 249 245 243 243 243 243 245 240
 234 213  39  21  31  38 188 245 243 241 242 242 243 244 244 242
 234 234 169  21  28 188 248 241 240 239 240 240 242 243 243 237
 233 234 237 183 165 241 238 238 237 238 239 238 241 242 244 233
 232 235 237 238 241 236 237 237 237 240 242 242 244 245 247 242
 211 201 222 214 211 217 210 224 222 220 225 219 230 229 221 222
 227 225 228 228 229 230 232 230 233 234 233 234 234 235 234 225
 227 226 227 227 229 230 231 233 225 229 217 222 224 231 234 221
 225 225 227 227 228 228 230 228  86  57  55  46  69 201 235 229
 223 224 225 224 226 229 230 223  56  31  35  35  50 220 235 224
 222 222 224 226 226 226 227 220  56  30  34  34  59 225 236 222
 222 222 223 225 224 226 227 162  27  30  32  34  51 207 235 229
 221 221 222 225 225 226 166  34  31  31  26  52  53 220 235 225
 222 222 222 224 223 173  27  29  33  46 157 218 222 232 233 218
 221 221 222 224 172  27  27  29  37 163 233 230 231 234 233 228
 222 220 223 169  27  26  26  32 157 231 231 229 231 233 234 224
 222 219 176  31  23  26  29 165 230 229 229 229 231 232 233 219
 220 198  45  18  24  25 156 228 227 228 228 230 231 231 233 225
 218 210 146  23  21 153 229 226 225 225 229 229 230 231 231 218
 218 215 207 159 142 221 224 224 225 225 226 226 228 230 230 217
 216 217 218 212 222 221 222 223 225 228 228 228 231 231 233 225
 199 182 196 195 203 206 197 203 201 199 209 205 201 205 199 209
 223 220 222 224 224 227 229 228 228 230 228 231 229 229 229 213
 222 221 224 222 224 224 228 230 219 217 202 213 218 227 230 206
 220 220 223 222 224 224 227 218  81  64  72  66  82 197 231 217
 220 220 220 221 224 223 227 214  54  30  31  34  52 212 230 216
 218 218 221 220 222 221 222 205  52  28  29  29  62 215 232 213
 216 217 219 221 221 222 218 137  21  29  28  29  62 200 232 220
 217 217 219 221 221 216 148  22  25  26  26  49  57 214 231 210
 216 217 219 220 214 150  20  24  29  45 154 193 206 228 228 204
 216 216 217 216 149  15  23  24  38 160 225 222 225 228 228 218
 216 215 212 152  16  19  25  30 155 226 225 224 226 228 228 212
 217 213 149  22  19  25  29 162 225 224 225 224 225 226 227 212
 216 177  33  14  22  26 155 224 222 223 223 224 225 226 228 217
 211 192 119  16  23 149 223 221 221 220 222 224 225 226 226 203
 214 205 185 138 136 217 219 220 221 222 222 223 224 225 225 203
 211 211 208 200 218 216 216 218 220 223 222 223 225 225 227 211

