 185 220 216 223 237 238 235 237 236 234 233 229 230 230 227 230
 197 244 245 243 239 228 244 242 241 242 242 240 241 242 240 239
 203 245 166  65  69  65 238 242 241 242 240 238 240 241 239 237
 212 247 158  44  49  44 235 243 240 239 240 240 239 237 239 239
 212 246 155  37  45  41 232 241 239 239 239 239 238 238 237 239
 215 243 168  42  43  43 219 240 240 239 239 237 238 238 234 237
 217 242 183  46  42  48 208 237 239 239 237 236 237 236 235 236
 224 242 194  40  46  33 211 234 236 236 237 237 235 235 233 237
 225 240 177  47  46  21 216 237 236 234 235 235 234 233 233 233
 227 240 178  51  49  18 213 235 233 233 233 232 232 231 231 231
 227 238 176  43  43  25 222 237 236 238 235 236 240 239 235 232
 226 239 171  39  42  40 155 159 135 134 114 110 115 112 155 229
 220 236 165  40  38  37  36  36  37  38  39  40  38  33  98 234
 208 235 157  31  28  21  21  24  23  23  29  26  22  15 101 233
 184 233 184 110 106 101 104  98 120 121 127 126 125 120 157 229
 189 236 237 237 239 237 232 234 234 233 234 232 234 232 233 231
 167 208 205 211 222 221 221 221 218 218 217 214 210 210 207 205
 190 232 233 229 228 215 231 230 229 229 229 227 228 228 226 226
 196 235 152  56  63  59 225 230 227 228 226 226 228 227 226 225
 200 236 137  28  38  31 220 230 227 226 226 226 225 224 226 228
 202 233 137  27  35  31 215 229 226 225 225 225 224 225 225 226
 205 232 138  26  33  33 203 227 227 225 225 224 224 224 221 223
 205 231 147  31  35  38 193 225 225 225 224 223 223 222 222 223
 213 231 162  35  41  26 197 224 223 223 224 224 222 221 219 223
 212 230 157  35  39  12 199 224 221 221 221 220 220 219 219 220
 216 228 161  35  39  12 200 221 219 220 219 218 219 218 219 218
 219 226 153  31  34  11 208 224 223 223 222 222 224 225 222 218
 214 227 147  27  32  24 131 146 134 136 126 120 120 118 152 219
 209 224 144  23  28  27  29  31  34  33  36  35  33  29  85 220
 199 223 137  17  20  15  14  17  18  16  20  18  16  13  83 218
 173 220 166  88  80  76  75  70  87  95 102 107 108 105 145 216
 180 222 219 216 216 219 217 218 218 216 216 214 214 215 215 217
 174 189 186 188 203 205 207 210 209 207 210 206 199 203 202 199
 199 227 227 223 223 207 222 225 222 224 224 221 222 223 221 217
 198 229 124  47  58  55 220 223 222 224 223 220 222 222 221 220
 204 230 106  25  34  35 220 224 222 222 222 220 221 218 221 220
 210 228 104  25  32  36 224 223 221 222 220 221 219 219 219 219
 204 226 104  25  26  36 208 219 222 221 220 219 219 218 216 217
 206 225 116  24  29  39 196 218 221 220 219 218 218 217 215 216
 195 223 132  27  32  23 198 219 218 219 219 218 215 216 214 217
 199 222 156  29  34  10 199 218 216 216 215 216 215 213 214 214
 191 220 159  30  35   9 197 216 214 216 214 214 213 212 213 211
 181 221 153  27  30   9 193 220 219 220 219 218 221 220 217 212
 190 220 153  24  29  23 136 141 130 123 114 116 120 115 140 210
 181 218 150  22  25  24  29  35  37  37  38  39  40  31  83 208
 175 217 137  14  15  13  13  16  17  15  20  15  13  11  78 207
 162 215 160  79  74  74  72  66  82  87  90  94  93  92 119 205
 168 217 206 201 203 206 204 204 202 201 201 198 199 206 204 209

 230 239 237 239 239 237 236 237 233 231 232 229 234 233 229 231
 227 240 239 239 237 234 235 233 233 231 235 155  98 101 157 233
 230 242 241 237 238 238 236 235 233 231 239 112  33  15 120 232
 230 241 240 239 238 238 237 235 234 232 240 115  38  22 125 234
 229 240 238 240 239 237 236 237 235 232 236 110  40  26 126 232
 233 242 240 240 239 239 237 237 235 233 235 114  39  29 127 234
 234 242 242 239 239 239 239 236 234 233 238 134  38  23 121 233
 236 241 241 240 239 240 239 236 236 233 236 135  37  23 120 234
 237 242 242 243 241 240 237 234 237 235 237 159  36  24  98 234
 235 244 238 235 232 219 208 211 216 213 222 155  36  21 104 232
 238 228  65  44  41  43  48  33  21  18  25  40  37  21 101 237
 237 239  69  49  45  43  42  46  46  49  43  42  38  28 106 239
 223 243  65  44  37  42  46  40  47  51  43  39  40  31 110 237
 216 245 166 158 155 168 183 194 177 178 176 171 165 157 184 237
 220 244 245 247 246 243 242 242 240 240 238 239 236 235 233 236
 185 197 203 212 212 215 217 224 225 227 227 226 220 208 184 189
 205 226 225 228 226 223 223 223 220 218 218 219 220 218 216 217
 207 226 226 226 225 221 222 219 219 219 222 152  85  83 145 215
 210 228 227 224 225 224 222 221 219 218 225 118  29  13 105 215
 210 228 228 225 224 224 223 222 220 219 224 120  33  16 108 214
 214 227 226 226 225 224 223 224 220 218 222 120  35  18 107 214
 217 229 226 226 225 225 224 224 221 219 222 126  36  20 102 216
 218 229 228 226 225 225 225 223 221 220 223 136  33  16  95 216
 218 229 227 227 226 227 225 223 221 219 223 134  34  18  87 218
 221 230 230 230 229 227 225 224 224 221 224 146  31  17  70 218
 221 231 225 220 215 203 193 197 199 200 208 131  29  14  75 217
 221 215  59  31  31  33  38  26  12  12  11  24  27  15  76 219
 222 228  63  38  35  33  35  41  39  39  34  32  28  20  80 216
 211 229  56  28  27  26  31  35  35  35  31  27  23  17  88 216
 205 233 152 137 137 138 147 162 157 161 153 147 144 137 166 219
 208 232 235 236 233 232 231 231 230 228 226 227 224 223 220 222
 167 190 196 200 202 205 205 213 212 216 219 214 209 199 173 180
 199 217 220 220 219 217 216 217 214 211 212 210 208 207 205 209
 202 221 221 221 219 216 215 214 214 213 217 140  83  78 119 204
 203 223 222 218 219 218 217 216 213 212 220 115  31  11  92 206
 199 222 222 221 219 219 218 215 215 213 221 120  40  13  93 199
 206 221 220 220 221 219 218 218 216 214 218 116  39  15  94 198
 210 224 223 222 220 220 219 219 215 214 219 114  38  20  90 201
 207 224 224 222 222 221 220 219 216 216 220 123  37  15  87 201
 209 222 222 222 221 222 221 218 216 214 219 130  37  17  82 202
 210 225 223 224 223 219 218 219 218 216 220 141  35  16  66 204
 207 222 220 220 224 208 196 198 199 197 193 136  29  13  72 204
 205 207  55  35  36  36  39  23  10   9   9  23  24  13  74 206
 203 223  58  34  32  26  29  32  34  35  30  29  25  15  74 203
 188 223  47  25  25  25  24  27  29  30  27  24  22  14  79 201
 186 227 124 106 104 104 116 132 156 159 153 153 150 137 160 206
 189 227 229 230 228 226 225 223 222 220 221 220 218 217 215 217
 174 199 198 204 210 204 206 195 199 191 181 190 181 175 162 168

 231 233 232 234 232 234 233 234 234 232 237 239 237 237 236 189
 229 157 120 125 126 127 121 120  98 104 101 106 110 184 233 184
 233 101  15  22  26  29  23  23  24  21  21  28  31 157 235 208
 234  98  33  38  40  39  38  37  36  36  37  38  40 165 236 220
 229 155 112 115 110 114 134 135 159 155  40  42  39 171 239 226
 232 235 239 240 236 235 238 236 237 222  25  43  43 176 238 227
 231 231 231 232 232 233 233 233 235 213  18  49  51 178 240 227
 233 233 233 234 235 235 234 236 237 216  21  46  47 177 240 225
 237 233 235 235 237 237 236 236 234 211  33  46  40 194 242 224
 236 235 236 237 236 237 239 239 237 208  48  42  46 183 242 217
 237 234 238 238 237 239 239 240 240 219  43  43  42 168 243 215
 239 237 238 238 239 239 239 239 241 232  41  45  37 155 246 212
 239 239 237 239 240 240 239 240 243 235  44  49  44 158 247 212
 237 239 241 240 238 240 242 241 242 238  65  69  65 166 245 203
 239 240 242 241 240 242 242 241 242 244 228 239 243 245 244 197
 230 227 230 230 229 233 234 236 237 235 238 237 223 216 220 185
 217 215 215 214 214 216 216 218 218 217 219 216 216 219 222 180
 216 145 105 108 107 102  95  87  70  75  76  80  88 166 220 173
 218  83  13  16  18  20  16  18  17  14  15  20  17 137 223 199
 220  85  29  33  35  36  33  34  31  29  27  28  23 144 224 209
 219 152 118 120 120 126 136 134 146 131  24  32  27 147 227 214
 218 222 225 224 222 222 223 223 224 208  11  34  31 153 226 219
 218 219 218 219 218 219 220 219 221 200  12  39  35 161 228 216
 220 219 219 220 220 221 221 221 224 199  12  39  35 157 230 212
 223 219 221 222 224 224 223 223 224 197  26  41  35 162 231 213
 223 222 222 223 223 224 225 225 225 193  38  35  31 147 231 205
 223 221 224 224 224 225 225 227 227 203  33  33  26 138 232 205
 226 225 225 224 225 225 225 226 229 215  31  35  27 137 233 202
 228 226 224 225 226 226 226 227 230 220  31  38  28 137 236 200
 225 226 227 228 226 226 228 227 230 225  59  63  56 152 235 196
 226 226 228 228 227 229 229 229 230 231 215 228 229 233 232 190
 205 207 210 210 214 217 218 218 221 221 221 222 211 205 208 167
 209 204 206 199 198 201 201 202 204 204 206 203 201 206 217 168
 205 119  92  93  94  90  87  82  66  72  74  74  79 160 215 162
 207  78  11  13  15  20  15  17  16  13  13  15  14 137 217 175
 208  83  31  40  39  38  37  37  35  29  24  25  22 150 218 181
 210 140 115 120 116 114 123 130 141 136  23  29  24 153 220 190
 212 217 220 221 218 219 220 219 220 193   9  30  27 153 221 181
 211 213 212 213 214 214 216 214 216 197   9  35  30 159 220 191
 214 214 213 215 216 215 216 216 218 199  10  34  29 156 222 199
 217 214 216 215 218 219 219 218 219 198  23  32  27 132 223 195
 216 215 217 218 218 219 220 221 218 196  39  29  24 116 225 206
 217 216 218 219 219 220 221 222 219 208  36  26  25 104 226 204
 219 219 219 219 221 220 222 221 223 224  36  32  25 104 228 210
 220 221 218 221 220 222 222 222 224 220  35  34  25 106 230 204
 220 221 222 222 220 223 224 222 223 220  55  58  47 124 229 198
 217 221 223 222 221 224 224 222 225 222 207 223 223 227 227 199
 199 202 203 199 206 210 207 209 210 207 205 203 188 186 189 174

 189 184 208 220 226 227 227 225 224 217 215 212 212 203 197 185
 236 233 235 236 239 238 240 240 242 242 243 246 247 245 244 220
 237 184 157 165 171 176 178 177 194 183 168 155 158 166 245 216
 237 110  31  40  39  43  51  47  40  46  42  37  44  65 243 223
 239 106  28  38  42  43  49  46  46  42  43  45  49  69 239 237
 237 101  21  37  40  25  18  21  33  48  43  41  44  65 228 238
 232 104  21  36 155 222 213 216 211 208 219 232 235 238 244 235
 234  98  24  36 159 237 235 237 234 237 240 241 243 242 242 237
 234 120  23  37 135 236 233 236 236 239 240 239 240 241 241 236
 233 121  23  38 134 238 233 234 236 239 239 239 239 242 242 234
 234 127  29  39 114 235 233 235 237 237 239 239 240 240 242 233
 232 126  26  40 110 236 232 235 237 236 237 239 240 238 240 229
 234 125  22  38 115 240 232 234 235 237 238 238 239 240 241 230
 232 120  15  33 112 239 231 233 235 236 238 238 237 241 242 230
 233 157 101  98 155 235 231 233 233 235 234 237 239 239 240 227
 231 229 233 234 229 232 231 233 237 236 237 239 239 237 239 230
 180 173 199 209 214 219 216 212 213 205 205 202 200 196 190 167
 222 220 223 224 227 226 228 230 231 231 232 233 236 235 232 208
 219 166 137 144 147 153 161 157 162 147 138 137 137 152 233 205
 216  88  17  23  27  31  35  35  35  31  26  27  28  56 229 211
 216  80  20  28  32  34  39  39  41  35  33  35  38  63 228 222
 219  76  15  27  24  11  12  12  26  38  33  31  31  59 215 221
 217  75  14  29 131 208 200 199 197 193 203 215 220 225 231 221
 218  70  17  31 146 224 221 224 224 225 227 229 230 230 230 221
 218  87  18  34 134 223 219 221 223 225 227 226 227 227 229 218
 216  95  16  33 136 223 220 221 223 225 225 225 226 228 229 218
 216 102  20  36 126 222 219 221 224 224 225 225 226 226 229 217
 214 107  18  35 120 222 218 220 224 223 224 225 226 226 227 214
 214 108  16  33 120 224 219 220 222 223 224 224 225 228 228 210
 215 105  13  29 118 225 218 219 221 222 224 225 224 227 228 210
 215 145  83  85 152 222 219 219 219 222 221 225 226 226 226 207
 217 216 218 220 219 218 218 220 223 223 223 226 228 225 226 205
 168 162 175 181 190 181 191 199 195 206 204 210 204 198 199 174
 217 215 217 218 220 221 220 222 223 225 226 228 230 229 227 189
 206 160 137 150 153 153 159 156 132 116 104 104 106 124 227 186
 201  79  14  22  24  27  30  29  27  24  25  25  25  47 223 188
 203  74  15  25  29  30  35  34  32  29  26  32  34  58 223 203
 206  74  13  24  23   9   9  10  23  39  36  36  35  55 207 205
 204  72  13  29 136 193 197 199 198 196 208 224 220 220 222 207
 204  66  16  35 141 220 216 218 219 218 219 223 224 223 225 210
 202  82  17  37 130 219 214 216 218 221 222 221 222 222 222 209
 201  87  15  37 123 220 216 216 219 220 221 222 222 224 224 207
 201  90  20  38 114 219 214 215 219 219 220 220 222 223 224 210
 198  94  15  39 116 218 214 216 218 218 219 221 220 220 221 206
 199  93  13  40 120 221 213 215 215 218 219 219 221 222 222 199
 206  92  11  31 115 220 212 213 216 217 218 219 218 222 223 203
 204 119  78  83 140 217 213 214 214 215 216 219 221 221 221 202
 209 205 207 208 210 212 211 214 217 216 217 219 220 220 217 199

