 229 225 230 224 223 222 223 222 213 220 216 212 217 216 205 215
 234 235 233 232 232 232 231 228 218 226 224 221 219 219 217 217
 226 229 226 226 226 224 223 170 115 220 216 213 211 211 210 210
 222 222 220 219 218 218 217  74  23 205 209 208 205 204 202 202
 209 213 212 208 168 141 110  16  14  75 130 157 193 201 201 201
 208 209 208 207 101  12  16  13  12  12  13  58 192 200 200 200
 200 207 206 207 208 115  12  13  12  12  63 196 199 199 198 200
 204 206 205 205 205 190  15  14  13  13 130 200 200 198 197 197
 197 204 203 204 203 150  11  41  63  11 103 198 197 197 196 195
 197 203 202 201 201 126 124 195 196 144 107 197 197 195 194 195
 197 201 201 201 200 199 199 198 197 198 200 197 196 193 194 194
 190 200 200 181  96  97  92  95  94  87  91  93 149 194 193 193
 194 199 198 164  11  14  13  11  12  11  10  10 111 193 192 190
 189 198 198 180  76  78  90  80  79  91  83  82 140 191 190 188
 193 197 198 197 196 197 196 194 195 194 192 191 192 191 188 187
 183 196 196 198 197 196 196 194 193 193 191 192 189 190 188 191
 227 229 229 223 227 224 221 225 217 219 218 216 215 215 210 215
 231 232 230 230 230 229 227 226 210 223 220 218 215 216 213 213
 223 225 224 222 222 221 220 160 105 215 210 210 208 208 207 205
 218 218 216 215 214 213 214  58  23 195 205 204 200 202 199 199
 208 210 208 204 157 131  96  12  13  67 119 147 187 198 198 198
 206 205 204 204 105  13  14  12  11  10  11  60 190 198 197 197
 197 203 203 202 203 116  12  12  10   9  62 193 197 196 195 195
 200 201 200 201 199 182   9  12  10  10 124 197 195 195 193 193
 196 200 200 199 199 141  10  39  65  10  96 194 193 193 192 192
 193 199 198 197 196 125 126 192 193 145 108 194 192 191 191 190
 192 197 197 197 195 194 195 195 194 195 194 193 192 190 190 191
 187 196 195 175  89  93  89  85  91  83  82  86 141 189 188 188
 192 195 194 158   9  12  11  10   9   9   9   8 104 188 186 186
 183 193 192 175  81  77  85  81  79  86  84  80 138 186 185 186
 186 192 192 190 191 191 190 189 189 187 187 185 186 185 183 183
 180 192 192 192 190 190 190 187 189 187 184 186 185 183 182 183
 227 228 231 227 227 226 224 223 218 222 220 216 219 217 211 217
 228 232 230 230 231 229 228 226 211 224 221 219 217 217 214 215
 223 226 224 223 223 221 220 167 106 215 213 210 209 210 208 208
 221 220 217 218 215 214 214  67  24 196 206 206 202 204 201 202
 206 212 210 205 158 130 100  13  14  69 121 144 189 202 200 201
 205 208 206 207 111  14  15  13  11  11  12  65 193 200 200 199
 205 205 205 205 206 117  13  12  10  10  65 197 200 200 199 199
 204 205 203 204 204 183  16  12  11  11 127 200 200 197 197 197
 194 203 203 203 202 145  12  48  73  12 105 198 197 196 196 196
 197 202 202 201 200 128 135 196 196 150 109 196 196 197 195 194
 200 201 201 201 199 198 198 198 198 197 199 196 196 194 196 194
 190 199 199 181  95  91  89  91  92  84  89  89 143 194 195 195
 190 198 199 157  12  12  11   9  10  10  10   9 107 193 193 192
 191 197 197 174  84  84  91  86  84  93  90  84 138 193 191 192
 194 197 196 196 195 196 195 196 195 194 194 192 193 191 189 189
 181 196 195 196 196 194 194 193 194 194 190 191 190 188 187 189

 215 217 210 202 201 200 200 197 195 195 194 193 190 188 187 191
 205 217 210 202 201 200 198 197 196 194 194 193 192 190 188 188
 216 219 211 204 201 200 199 198 197 195 193 194 193 191 191 190
 217 219 211 205 193 192 199 200 197 197 196 149 111 140 192 189
 212 221 213 208 157  58 196 200 198 197 197  93  10  82 191 192
 216 224 216 209 130  13  63 130 103 107 200  91  10  83 192 191
 220 226 220 205  75  12  12  13  11 144 198  87  11  91 194 193
 213 218 115  23  14  12  12  13  63 196 197  94  12  79 195 193
 222 228 170  74  16  13  13  14  41 195 198  95  11  80 194 194
 223 231 223 217 110  16  12  15  11 124 199  92  13  90 196 196
 222 232 224 218 141  12 115 190 150 126 199  97  14  78 197 196
 223 232 226 218 168 101 208 205 203 201 200  96  11  76 196 197
 224 232 226 219 208 207 207 205 204 201 201 181 164 180 197 198
 230 233 226 220 212 208 206 205 203 202 201 200 198 198 198 196
 225 235 229 222 213 209 207 206 204 203 201 200 199 198 197 196
 229 234 226 222 209 208 200 204 197 197 197 190 194 189 193 183
 215 213 205 199 198 197 195 193 192 190 191 188 186 186 183 183
 210 213 207 199 198 197 195 193 192 191 190 188 186 185 183 182
 215 216 208 202 198 198 196 195 193 191 190 189 188 186 185 183
 215 215 208 200 187 190 197 195 193 192 192 141 104 138 186 185
 216 218 210 204 147  60 193 197 194 194 193  86   8  80 185 186
 218 220 210 205 119  11  62 124  96 108 194  82   9  84 187 184
 219 223 215 195  67  10   9  10  10 145 195  83   9  86 187 187
 217 210 105  23  13  11  10  10  65 193 194  91   9  79 189 189
 225 226 160  58  12  12  12  12  39 192 195  85  10  81 189 187
 221 227 220 214  96  14  12   9  10 126 195  89  11  85 190 190
 224 229 221 213 131  13 116 182 141 125 194  93  12  77 191 190
 227 230 222 214 157 105 203 199 199 196 195  89   9  81 191 190
 223 230 222 215 204 204 202 201 199 197 197 175 158 175 190 192
 229 230 224 216 208 204 203 200 200 198 197 195 194 192 192 192
 229 232 225 218 210 205 203 201 200 199 197 196 195 193 192 192
 227 231 223 218 208 206 197 200 196 193 192 187 192 183 186 180
 217 215 208 202 201 199 199 197 196 194 194 195 192 192 189 189
 211 214 208 201 200 200 199 197 196 195 196 195 193 191 189 187
 217 217 210 204 202 200 200 197 196 197 194 194 193 193 191 188
 219 217 209 202 189 193 200 200 197 196 196 143 107 138 193 190
 216 219 210 206 144  65 197 200 198 196 196  89   9  84 192 191
 220 221 213 206 121  12  65 127 105 109 199  89  10  90 194 190
 222 224 215 196  69  11  10  11  12 150 197  84  10  93 194 194
 218 211 106  24  14  11  10  11  73 196 198  92  10  84 195 194
 223 226 167  67  13  13  12  12  48 196 198  91   9  86 196 193
 224 228 220 214 100  15  13  16  12 135 198  89  11  91 195 194
 226 229 221 214 130  14 117 183 145 128 198  91  12  84 196 194
 227 231 223 215 158 111 206 204 202 200 199  95  12  84 195 196
 227 230 223 218 205 207 205 204 203 201 201 181 157 174 196 196
 231 230 224 217 210 206 205 203 203 202 201 199 199 197 196 195
 228 232 226 220 212 208 205 205 203 202 201 199 198 197 197 196
 227 228 223 221 206 205 205 204 194 197 200 190 190 191 194 181

 191 188 190 189 192 191 193 193 194 196 196 197 198 196 196 183
 187 188 191 192 191 192 194 195 194 196 197 196 197 198 197 193
 188 190 191 140  82  83  91  79  80  90  78  76 180 198 198 189
 190 192 193 111  10  10  11  12  11  13  14  11 164 198 199 194
 193 193 194 149  93  91  87  94  95  92  97  96 181 200 200 190
 194 194 193 196 197 200 198 197 198 199 199 200 201 201 201 197
 195 194 195 197 197 107 144 196 195 124 126 201 201 202 203 197
 195 196 197 197 198 103  11  63  41  11 150 203 204 203 204 197
 197 197 198 200 200 130  13  13  14  15 190 205 205 205 206 204
 200 198 199 199 196  63  12  12  13  12 115 208 207 206 207 200
 200 200 200 192  58  13  12  12  13  16  12 101 207 208 209 208
 201 201 201 193 157 130  75  14  16 110 141 168 208 212 213 209
 202 202 204 205 208 209 205  23  74 217 218 218 219 220 222 222
 210 210 211 211 213 216 220 115 170 223 224 226 226 226 229 226
 217 217 219 219 221 224 226 218 228 231 232 232 232 233 235 234
 215 205 216 217 212 216 220 213 222 223 222 223 224 230 225 229
 183 182 183 185 186 184 187 189 187 190 190 190 192 192 192 180
 183 183 185 186 185 187 187 189 189 190 191 191 190 192 192 186
 186 185 186 138  80  84  86  79  81  85  77  81 175 192 193 183
 186 186 188 104   8   9   9   9  10  11  12   9 158 194 195 192
 188 188 189 141  86  82  83  91  85  89  93  89 175 195 196 187
 191 190 190 192 193 194 195 194 195 195 194 195 197 197 197 192
 190 191 191 192 194 108 145 193 192 126 125 196 197 198 199 193
 192 192 193 193 194  96  10  65  39  10 141 199 199 200 200 196
 193 193 195 195 197 124  10  10  12   9 182 199 201 200 201 200
 195 195 196 197 193  62   9  10  12  12 116 203 202 203 203 197
 197 197 198 190  60  11  10  11  12  14  13 105 204 204 205 206
 198 198 198 187 147 119  67  13  12  96 131 157 204 208 210 208
 199 199 202 200 204 205 195  23  58 214 213 214 215 216 218 218
 205 207 208 208 210 210 215 105 160 220 221 222 222 224 225 223
 213 213 216 215 218 220 223 210 226 227 229 230 230 230 232 231
 215 210 215 215 216 218 219 217 225 221 224 227 223 229 229 227
 189 187 188 190 191 190 194 194 193 194 194 196 196 195 196 181
 189 189 191 193 192 194 194 195 196 195 196 195 196 196 197 194
 192 191 193 138  84  90  93  84  86  91  84  84 174 197 197 191
 192 193 193 107   9  10  10  10   9  11  12  12 157 199 198 190
 195 195 194 143  89  89  84  92  91  89  91  95 181 199 199 190
 194 196 194 196 196 199 197 198 198 198 198 199 201 201 201 200
 194 195 197 196 196 109 150 196 196 135 128 200 201 202 202 197
 196 196 196 197 198 105  12  73  48  12 145 202 203 203 203 194
 197 197 197 200 200 127  11  11  12  16 183 204 204 203 205 204
 199 199 200 200 197  65  10  10  12  13 117 206 205 205 205 205
 199 200 200 193  65  12  11  11  13  15  14 111 207 206 208 205
 201 200 202 189 144 121  69  14  13 100 130 158 205 210 212 206
 202 201 204 202 206 206 196  24  67 214 214 215 218 217 220 221
 208 208 210 209 210 213 215 106 167 220 221 223 223 224 226 223
 215 214 217 217 219 221 224 211 226 228 229 231 230 230 232 228
 217 211 217 219 216 220 222 218 223 224 226 227 227 231 228 227

 183 193 189 194 190 197 197 197 204 200 208 209 222 226 234 229
 196 197 198 199 200 201 203 204 206 207 209 213 222 229 235 225
 196 198 198 198 200 201 202 203 205 206 208 212 220 226 233 230
 198 197 180 164 181 201 201 204 205 207 207 208 219 226 232 224
 197 196  76  11  96 200 201 203 205 208 101 168 218 226 232 223
 196 197  78  14  97 199 126 150 190 115  12 141 218 224 232 222
 196 196  90  13  92 199 124  11  15  12  16 110 217 223 231 223
 194 194  80  11  95 198 195  41  14  13  13  16  74 170 228 222
 193 195  79  12  94 197 196  63  13  12  12  14  23 115 218 213
 193 194  91  11  87 198 144  11  13  12  12  75 205 220 226 220
 191 192  83  10  91 200 107 103 130  63  13 130 209 216 224 216
 192 191  82  10  93 197 197 198 200 196  58 157 208 213 221 212
 189 192 140 111 149 196 197 197 200 199 192 193 205 211 219 217
 190 191 191 193 194 193 195 197 198 199 200 201 204 211 219 216
 188 188 190 192 193 194 194 196 197 198 200 201 202 210 217 205
 191 187 188 190 193 194 195 195 197 200 200 201 202 210 217 215
 180 186 183 192 187 192 193 196 200 197 206 208 218 223 231 227
 192 192 193 195 196 197 199 200 201 203 205 210 218 225 232 229
 192 192 192 194 195 197 198 200 200 203 204 208 216 224 230 229
 192 190 175 158 175 197 197 199 201 202 204 204 215 222 230 223
 190 191  81   9  89 195 196 199 199 203 105 157 214 222 230 227
 190 191  77  12  93 194 125 141 182 116  13 131 213 221 229 224
 190 190  85  11  89 195 126  10   9  12  14  96 214 220 227 221
 187 189  81  10  85 195 192  39  12  12  12  12  58 160 226 225
 189 189  79   9  91 194 193  65  10  10  11  13  23 105 210 217
 187 187  86   9  83 195 145  10  10   9  10  67 195 215 223 219
 184 187  84   9  82 194 108  96 124  62  11 119 205 210 220 218
 186 185  80   8  86 193 194 194 197 193  60 147 204 210 218 216
 185 186 138 104 141 192 192 193 195 197 190 187 200 208 215 215
 183 185 186 188 189 190 191 193 195 196 198 198 202 208 216 215
 182 183 185 186 188 190 191 192 193 195 197 198 199 207 213 210
 183 183 186 186 188 191 190 192 193 195 197 198 199 205 213 215
 181 194 191 190 190 200 197 194 204 205 205 206 221 223 228 227
 196 197 197 198 199 201 202 203 205 205 208 212 220 226 232 228
 195 196 197 199 199 201 202 203 203 205 206 210 217 224 230 231
 196 196 174 157 181 201 201 203 204 205 207 205 218 223 230 227
 196 195  84  12  95 199 200 202 204 206 111 158 215 223 231 227
 194 196  84  12  91 198 128 145 183 117  14 130 214 221 229 226
 194 195  91  11  89 198 135  12  16  13  15 100 214 220 228 224
 193 196  86   9  91 198 196  48  12  12  13  13  67 167 226 223
 194 195  84  10  92 198 196  73  11  10  11  14  24 106 211 218
 194 194  93  10  84 197 150  12  11  10  11  69 196 215 224 222
 190 194  90  10  89 199 109 105 127  65  12 121 206 213 221 220
 191 192  84   9  89 196 196 198 200 197  65 144 206 210 219 216
 190 193 138 107 143 196 196 197 200 200 193 189 202 209 217 219
 188 191 193 193 194 194 197 196 197 200 200 202 204 210 217 217
 187 189 191 193 195 196 195 196 197 199 200 200 201 208 214 211
 189 189 192 192 195 194 194 196 197 199 199 201 202 208 215 217

