 220 218 212 207 210 211 211 209 207 205 202 198 194 190 186 184
 225 223 222 223 222 219 215 216 214 214 214 216 214 213 211 209
 216 223 223 221 219 218 217 218 216 213 214 213 213 211 208 208
 217 219 220 218 216 215 216 216 215 216 215 213 211 211 206 205
 216 219 218 218 215 217 216 213 213 215 213 208 207 208 205 206
 217 219 219 216 215 214 214 212 196 214 210 209 208 208 206 204
 216 217 217 216 216 216 216 173  70 182 212 209 206 207 207 205
 210 216 214 212 211 212 170  60  19  46 189 210 206 204 205 203
 186 197 196 200 204 172  58  22  11  11  25 160 195 195 195 198
  36  44  35  37  46  49  27  12  10  11  12  38  67  53  51  49
  11  11  11  12  13  11  14  14   9  14  12  11  10  11  11   9
  50  44  36  33  27  40  41  49  51  48  42  37  31  29  25  23
 201 204 203 202 198 194 196 190 188 194 193 195 194 190 189 189
 205 209 210 206 206 205 207 203 203 206 204 201 199 200 197 192
 200 209 207 206 207 205 204 201 202 203 200 200 197 196 196 191
 199 208 208 204 203 202 200 199 203 200 201 199 199 197 196 195
 199 203 199 196 201 202 202 201 197 195 192 188 184 178 175 170
 207 210 210 212 209 209 209 208 206 206 207 205 202 203 201 203
 199 211 211 210 210 208 208 207 206 205 204 202 202 202 200 203
 199 209 210 207 208 207 207 206 205 204 203 204 202 201 200 202
 200 206 206 208 208 205 205 204 205 204 202 202 199 200 198 201
 201 205 205 206 204 204 204 206 199 204 201 201 200 200 199 200
 189 205 207 205 204 203 207 168  84 169 201 201 200 198 198 199
 189 203 204 204 204 205 166  76  29  36 170 200 199 197 197 197
 168 190 194 194 198 172  84  30  12   9  17 141 188 192 192 195
  17  40  40  44  45  43  28  12   9   8   8  22  57  54  54  50
   7   8   9  11  12  11  11  10   7  10   8   9   8   8   9   8
  42  33  29  23  20  32  31  43  44  40  34  29  25  25  20  18
 183 191 191 188 185 184 183 178 177 180 181 182 182 180 177 175
 186 196 198 197 196 195 196 195 194 194 194 194 193 191 188 188
 173 196 195 197 196 195 195 194 194 193 193 192 192 190 186 187
 174 198 199 198 197 196 195 195 193 191 193 192 191 192 190 188
 181 189 190 188 191 192 191 187 186 182 178 174 172 165 160 158
 183 204 206 205 204 204 204 201 200 200 199 200 198 196 193 194
 176 204 205 205 203 203 205 202 199 198 199 197 197 196 195 196
 175 203 203 203 203 203 202 201 199 200 200 200 196 195 195 195
 180 200 202 203 200 202 201 199 200 198 197 195 194 194 193 195
 179 200 201 199 199 201 200 201 194 199 195 195 194 194 193 194
 172 198 201 199 199 199 204 173  87 162 196 195 194 191 191 194
 172 197 199 199 200 202 171  91  38  41 166 194 193 192 191 191
 167 186 192 193 196 178 101  40  16  10  23 143 183 186 188 190
  27  54  57  57  54  57  35  14   9   9   8  28  63  65  68  63
   7   9  10  13  13  12  13  11   7  10   8   8   8  10  11  10
  36  29  23  18  16  24  23  36  38  36  32  28  23  22  18  16
 163 178 176 174 173 168 167 163 161 170 169 171 168 167 163 161
 155 187 191 190 189 189 189 189 188 188 186 186 184 184 181 180
 159 189 190 189 191 192 190 189 189 189 187 186 185 185 181 181
 160 192 193 192 191 191 190 189 188 188 189 187 187 187 186 183

 184 209 208 205 206 204 205 203 198  49   9  23 189 192 191 195
 186 211 208 206 205 206 207 205 195  51  11  25 189 197 196 196
 190 213 211 211 208 208 207 204 195  53  11  29 190 200 196 197
 194 214 213 211 207 208 206 206 195  67  10  31 194 199 197 199
 198 216 213 213 208 209 209 210 160  38  11  37 195 201 200 199
 202 214 214 215 213 210 212 189  25  12  12  42 193 204 200 201
 205 214 213 216 215 214 182  46  11  11  14  48 194 206 203 200
 207 214 216 215 213 196  70  19  11  10   9  51 188 203 202 203
 209 216 218 216 213 212 173  60  22  12  14  49 190 203 201 199
 211 215 217 216 216 214 216 170  58  27  14  41 196 207 204 200
 211 219 218 215 217 214 216 212 172  49  11  40 194 205 205 202
 210 222 219 216 215 215 216 211 204  46  13  27 198 206 207 203
 207 223 221 218 218 216 216 212 200  37  12  33 202 206 206 204
 212 222 223 220 218 219 217 214 196  35  11  36 203 210 207 208
 218 223 223 219 219 219 217 216 197  44  11  44 204 209 209 208
 220 225 216 217 216 217 216 210 186  36  11  50 201 205 200 199
 170 203 203 202 201 200 199 197 195  50   8  18 175 188 187 188
 175 201 200 200 198 199 198 197 192  54   9  20 177 188 186 190
 178 203 202 201 200 200 198 197 192  54   8  25 180 191 190 192
 184 202 202 202 199 200 200 199 188  57   8  25 182 193 192 191
 188 205 202 204 202 201 201 200 141  22   9  29 182 194 192 192
 192 207 204 203 202 201 201 170  17   8   8  34 181 194 193 193
 195 206 205 204 204 204 169  36   9   8  10  40 180 194 193 191
 197 206 206 205 205 199  84  29  12   9   7  44 177 194 194 193
 201 208 207 206 204 206 168  76  30  12  10  43 178 195 194 195
 202 209 208 207 205 204 207 166  84  28  11  31 183 196 195 195
 202 209 208 207 205 204 203 205 172  43  11  32 184 195 195 196
 201 209 210 208 208 204 204 204 198  45  12  20 185 196 196 197
 196 212 210 207 208 206 205 204 194  44  11  23 188 197 197 198
 199 210 211 210 206 205 207 204 194  40   9  29 191 198 195 199
 203 210 211 209 206 205 205 203 190  40   8  33 191 196 196 198
 199 207 199 199 200 201 189 189 168  17   7  42 183 186 173 174
 158 194 196 195 195 194 194 191 190  63  10  16 161 180 181 183
 160 193 195 195 193 193 191 191 188  68  11  18 163 181 181 186
 165 196 196 195 194 194 191 192 186  65  10  22 167 184 185 187
 172 198 197 196 194 194 194 193 183  63   8  23 168 184 185 187
 174 200 197 200 195 195 195 194 143  28   8  28 171 186 186 187
 178 199 199 200 197 195 196 166  23   8   8  32 169 186 187 189
 182 200 198 200 198 199 162  41  10   9  10  36 170 188 189 188
 186 200 199 199 200 194  87  38  16   9   7  38 161 188 189 188
 187 201 202 201 199 201 173  91  40  14  11  36 163 189 189 189
 191 204 205 202 201 200 204 171 101  35  13  23 167 189 190 190
 192 204 203 203 202 201 199 202 178  57  12  24 168 189 192 191
 191 204 203 203 200 199 199 200 196  54  13  16 173 189 191 191
 188 205 205 203 203 199 199 199 193  57  13  18 174 190 189 192
 190 206 205 203 202 201 201 199 192  57  10  23 176 191 190 193
 189 204 204 203 200 200 198 197 186  54   9  29 178 187 189 192
 181 183 176 175 180 179 172 172 167  27   7  36 163 155 159 160

 195 196 197 199 199 201 200 203 199 200 202 203 204 208 208 199
 191 196 196 197 200 200 203 202 201 204 205 207 206 207 209 200
 192 197 200 199 201 204 206 203 203 207 205 206 206 210 209 205
 189 189 190 194 195 193 194 188 190 196 194 198 202 203 204 201
  23  25  29  31  37  42  48  51  49  41  40  27  33  36  44  50
   9  11  11  10  11  12  14   9  14  14  11  13  12  11  11  11
  49  51  53  67  38  12  11  10  12  27  49  46  37  35  44  36
 198 195 195 195 160  25  11  11  22  58 172 204 200 196 197 186
 203 205 204 206 210 189  46  19  60 170 212 211 212 214 216 210
 205 207 207 206 209 212 182  70 173 216 216 216 216 217 217 216
 204 206 208 208 209 210 214 196 212 214 214 215 216 219 219 217
 206 205 208 207 208 213 215 213 213 216 217 215 218 218 219 216
 205 206 211 211 213 215 216 215 216 216 215 216 218 220 219 217
 208 208 211 213 213 214 213 216 218 217 218 219 221 223 223 216
 209 211 213 214 216 214 214 214 216 215 219 222 223 222 223 225
 184 186 190 194 198 202 205 207 209 211 211 210 207 212 218 220
 188 190 192 191 192 193 191 193 195 195 196 197 198 199 198 174
 187 186 190 192 192 193 193 194 194 195 195 196 197 195 196 173
 188 188 191 193 194 194 194 194 195 196 195 196 197 198 196 186
 175 177 180 182 182 181 180 177 178 183 184 185 188 191 191 183
  18  20  25  25  29  34  40  44  43  31  32  20  23  29  33  42
   8   9   8   8   9   8  10   7  10  11  11  12  11   9   8   7
  50  54  54  57  22   8   8   9  12  28  43  45  44  40  40  17
 195 192 192 188 141  17   9  12  30  84 172 198 194 194 190 168
 197 197 197 199 200 170  36  29  76 166 205 204 204 204 203 189
 199 198 198 200 201 201 169  84 168 207 203 204 205 207 205 189
 200 199 200 200 201 201 204 199 206 204 204 204 206 205 205 201
 201 198 200 199 202 202 204 205 204 205 205 208 208 206 206 200
 202 200 201 202 204 203 204 205 206 207 207 208 207 210 209 199
 203 200 202 202 202 204 205 206 207 208 208 210 210 211 211 199
 203 201 203 202 205 207 206 206 208 209 209 209 212 210 210 207
 170 175 178 184 188 192 195 197 201 202 202 201 196 199 203 199
 183 186 187 187 187 189 188 188 189 190 191 191 192 193 192 160
 181 181 185 185 186 187 189 189 189 190 192 191 189 190 189 159
 180 181 184 184 186 186 188 188 189 189 189 189 190 191 187 155
 161 163 167 168 171 169 170 161 163 167 168 173 174 176 178 163
  16  18  22  23  28  32  36  38  36  23  24  16  18  23  29  36
  10  11  10   8   8   8  10   7  11  13  12  13  13  10   9   7
  63  68  65  63  28   8   9   9  14  35  57  54  57  57  54  27
 190 188 186 183 143  23  10  16  40 101 178 196 193 192 186 167
 191 191 192 193 194 166  41  38  91 171 202 200 199 199 197 172
 194 191 191 194 195 196 162  87 173 204 199 199 199 201 198 172
 194 193 194 194 195 195 199 194 201 200 201 199 199 201 200 179
 195 193 194 194 195 197 198 200 199 201 202 200 203 202 200 180
 195 195 195 196 200 200 200 199 201 202 203 203 203 203 203 175
 196 195 196 197 197 199 198 199 202 205 203 203 205 205 204 176
 194 193 196 198 200 199 200 200 201 204 204 204 205 206 204 183
 158 160 165 172 174 178 182 186 187 191 192 191 188 190 189 181

 199 200 205 201  50  11  36 186 210 216 217 216 217 216 225 220
 208 209 209 204  44  11  44 197 216 217 219 219 219 223 223 218
 208 207 210 203  36  11  35 196 214 217 219 218 220 223 222 212
 204 206 206 202  33  12  37 200 212 216 216 218 218 221 223 207
 203 207 206 198  27  13  46 204 211 216 215 215 216 219 222 210
 202 205 205 194  40  11  49 172 212 216 214 217 215 218 219 211
 200 204 207 196  41  14  27  58 170 216 214 216 216 217 215 211
 199 201 203 190  49  14  12  22  60 173 212 213 216 218 216 209
 203 202 203 188  51   9  10  11  19  70 196 213 215 216 214 207
 200 203 206 194  48  14  11  11  46 182 214 215 216 213 214 205
 201 200 204 193  42  12  12  25 189 212 210 213 215 214 214 202
 199 200 201 195  37  11  38 160 210 209 209 208 213 213 216 198
 199 197 199 194  31  10  67 195 206 206 208 207 211 213 214 194
 197 196 200 190  29  11  53 195 204 207 208 208 211 211 213 190
 196 196 197 189  25  11  51 195 205 207 206 205 206 208 211 186
 195 191 192 189  23   9  49 198 203 205 204 206 205 208 209 184
 174 173 186 183  42   7  17 168 189 189 201 200 199 199 207 199
 198 196 196 191  33   8  40 190 203 205 205 206 209 211 210 203
 199 195 198 191  29   9  40 194 204 207 205 206 210 211 210 199
 198 197 197 188  23  11  44 194 204 205 206 208 207 210 212 196
 197 196 196 185  20  12  45 198 204 204 204 208 208 210 209 201
 196 195 195 184  32  11  43 172 205 203 204 205 207 208 209 202
 195 195 196 183  31  11  28  84 166 207 204 205 207 208 209 202
 195 194 195 178  43  10  12  30  76 168 206 204 206 207 208 201
 193 194 194 177  44   7   9  12  29  84 199 205 205 206 206 197
 191 193 194 180  40  10   8   9  36 169 204 204 204 205 206 195
 193 193 194 181  34   8   8  17 170 201 201 202 203 204 207 192
 192 192 194 182  29   9  22 141 200 201 201 202 204 202 205 188
 191 192 193 182  25   8  57 188 199 200 200 199 202 202 202 184
 192 190 191 180  25   8  54 192 197 198 200 200 201 202 203 178
 190 186 188 177  20   9  54 192 197 198 199 198 200 200 201 175
 188 187 188 175  18   8  50 195 197 199 200 201 202 203 203 170
 160 159 155 163  36   7  27 167 172 172 179 180 175 176 183 181
 192 189 187 178  29   9  54 186 197 198 200 200 203 204 204 189
 193 190 191 176  23  10  57 192 199 201 201 202 203 205 206 190
 192 189 190 174  18  13  57 193 199 199 199 203 203 205 205 188
 191 191 189 173  16  13  54 196 200 199 199 200 203 203 204 191
 191 192 189 168  24  12  57 178 202 199 201 202 203 203 204 192
 190 190 189 167  23  13  35 101 171 204 200 201 202 205 204 191
 189 189 189 163  36  11  14  40  91 173 201 199 201 202 201 187
 188 189 188 161  38   7   9  16  38  87 194 200 199 199 200 186
 188 189 188 170  36  10   9  10  41 162 199 198 200 198 200 182
 189 187 186 169  32   8   8  23 166 196 195 197 200 199 199 178
 187 186 186 171  28   8  28 143 194 195 195 195 200 197 200 174
 187 185 184 168  23   8  63 183 193 194 194 194 196 197 198 172
 187 185 184 167  22  10  65 186 192 191 194 194 195 196 196 165
 186 181 181 163  18  11  68 188 191 191 193 193 195 195 193 160
 183 181 180 161  16  10  63 190 191 194 194 195 195 196 194 158

