 133 124 126 129 133 136 138 143 149 151 149 148 149 151 153 146
 137 125 128 134 136 138 140 145 147 147 149 152 149 151 149 148
 136 126 128 134 137 139 143 145 147 144 153 153 150 151 147 150
 135 129 131 136 129 142 143 140 106 107 132 148 149 143 150 150
 130 127 129 133 132 139 141  98  47  49 100 147 148 148 148 148
 115 128 129 133 134 140 115  47  58  47 104 147 145 148 150 153
 123 132 129 137 138 125  46  94  94  47 112 145 150 149 150 149
 127 131 133 137 138  48  76 141  93  45 118 145 144 145 146 144
 127 129 132 137  84  39 103  98  61  43  88 124 143 141 145 147
 130 132 133 138  76  52  55  50  42  45  45  99 140 142 145 148
 136 129 135 140 129 130 127 128  63  42  98 141 142 146 147 147
 139 130 139 138 139 141 143 142  93  49 116 146 141 143 144 146
 130 135 136 140 141 146 144 144 135 127 137 145 143 146 144 148
 131 131 137 138 139 141 143 141 143 142 141 141 144 146 142 150
 138 136 138 137 139 141 142 143 140 143 141 142 143 141 145 151
 110 110 121 114 104 106 108 113 118 112 119 121 120 104 104 111
 148 154 155 156 158 160 163 166 167 169 170 169 169 172 173 169
 151 154 155 157 160 161 165 167 168 169 170 171 173 173 172 170
 151 155 156 158 160 161 166 167 168 169 171 172 173 172 172 167
 151 155 158 159 161 164 166 164 120 117 150 170 171 172 172 168
 153 156 159 160 163 164 164 104  43  46 110 170 171 172 171 169
 140 155 159 160 161 163 131  44  54  44 111 169 170 170 169 168
 142 156 159 160 161 147  49  97  96  42 119 170 169 169 170 169
 145 158 160 160 157  60  76 157  94  41 122 167 168 169 170 170
 149 158 161 160  92  42 106 112  63  39  88 138 168 169 168 167
 152 159 160 161  80  46  46  48  44  40  47  98 169 168 167 167
 154 160 161 162 151 153 148 143  70  39 101 156 167 167 166 167
 156 160 161 164 165 166 166 165 100  49 121 166 168 167 168 168
 150 160 162 163 163 166 166 166 156 148 161 167 167 167 167 167
 152 161 162 164 164 167 167 167 166 167 168 168 167 166 167 168
 154 160 162 164 164 166 166 166 166 167 167 167 167 166 166 167
 121 133 138 135 129 132 138 145 136 131 137 142 143 131 128 132
 135 137 139 141 140 142 146 148 149 150 151 151 152 153 153 156
 138 138 138 140 142 143 147 149 150 151 151 153 152 154 154 156
 138 137 139 140 143 145 147 148 150 151 153 153 153 150 153 154
 139 139 141 142 145 146 147 147 101 106 134 150 152 152 153 153
 139 138 141 143 144 145 146  93  33  33  98 150 152 153 152 152
 126 139 143 143 144 148 118  34  48  31  96 150 151 151 150 152
 130 140 143 143 144 134  39  82  89  35 103 151 149 150 151 150
 135 139 141 142 141  47  63 136  85  31 104 148 150 151 151 152
 137 140 143 145  79  32  95 102  58  26  78 124 150 151 150 152
 141 141 143 142  71  34  28  32  32  28  34  80 149 150 150 152
 141 141 143 145 131 131 127 125  57  31  92 136 148 149 149 152
 142 144 144 145 147 148 147 150  89  36 110 147 150 149 149 151
 130 143 144 145 147 148 149 148 133 126 138 148 148 148 149 151
 134 143 145 145 146 148 148 148 147 147 149 149 148 148 149 151
 139 142 143 145 146 147 147 148 147 148 148 147 148 148 147 151
 113 122 126 121 118 123 130 135 123 121 126 126 127 118 119 124

 146 148 150 150 148 153 149 144 147 148 147 146 148 150 151 111
 153 149 147 150 148 150 150 146 145 145 147 144 144 142 145 104
 151 151 151 143 148 148 149 145 141 142 146 143 146 146 141 104
 149 149 150 149 148 145 150 144 143 140 142 141 143 144 143 120
 148 152 153 148 147 147 145 145 124  99 141 146 145 141 142 121
 149 149 153 132 100 104 112 118  88  45  98 116 137 141 141 119
 151 147 144 107  49  47  47  45  43  45  42  49 127 142 143 112
 149 147 147 106  47  58  94  93  61  42  63  93 135 143 140 118
 143 145 145 140  98  47  94 141  98  50 128 142 144 141 143 113
 138 140 143 143 141 115  46  76 103  55 127 143 144 143 142 108
 136 138 139 142 139 140 125  48  39  52 130 141 146 141 141 106
 133 136 137 129 132 134 138 138  84  76 129 139 141 139 139 104
 129 134 134 136 133 133 137 137 137 138 140 138 140 138 137 114
 126 128 128 131 129 129 129 133 132 133 135 139 136 137 138 121
 124 125 126 129 127 128 132 131 129 132 129 130 135 131 136 110
 133 137 136 135 130 115 123 127 127 130 136 139 130 131 138 110
 169 170 167 168 169 168 169 170 167 167 167 168 167 168 167 132
 173 172 172 172 171 169 170 170 168 167 166 168 167 167 166 128
 172 173 172 172 172 170 169 169 169 168 167 167 167 166 166 131
 169 173 173 171 171 170 169 168 168 169 167 168 167 167 167 143
 169 171 172 170 170 169 170 167 138  98 156 166 167 168 167 142
 170 170 171 150 110 111 119 122  88  47 101 121 161 168 167 137
 169 169 169 117  46  44  42  41  39  40  39  49 148 167 167 131
 167 168 168 120  43  54  96  94  63  44  70 100 156 166 166 136
 166 167 167 164 104  44  97 157 112  48 143 165 166 167 166 145
 163 165 166 166 164 131  49  76 106  46 148 166 166 167 166 138
 160 161 161 164 164 163 147  60  42  46 153 166 166 167 166 132
 158 160 160 161 163 161 161 157  92  80 151 165 163 164 164 129
 156 157 158 159 160 160 160 160 160 161 162 164 163 164 164 135
 155 155 156 158 159 159 159 160 161 160 161 161 162 162 162 138
 154 154 155 155 156 155 156 158 158 159 160 160 160 161 160 133
 148 151 151 151 153 140 142 145 149 152 154 156 150 152 154 121
 156 156 154 153 152 152 150 152 152 152 152 151 151 151 151 124
 153 154 153 153 152 150 151 151 150 150 149 149 149 149 147 119
 153 154 150 152 153 151 150 151 151 150 149 149 148 148 148 118
 152 152 153 152 152 151 149 150 150 149 148 150 148 148 148 127
 151 153 153 150 150 150 151 148 124  80 136 147 148 149 147 126
 151 151 153 134  98  96 103 104  78  34  92 110 138 149 148 126
 150 151 151 106  33  31  35  31  26  28  31  36 126 147 148 121
 149 150 150 101  33  48  89  85  58  32  57  89 133 147 147 123
 148 149 148 147  93  34  82 136 102  32 125 150 148 148 148 135
 146 147 147 147 146 118  39  63  95  28 127 147 149 148 147 130
 142 143 145 146 145 148 134  47  32  34 131 148 148 148 147 123
 140 142 143 145 144 144 144 141  79  71 131 147 147 146 146 118
 141 140 140 142 143 143 143 142 145 142 145 145 145 145 145 121
 139 138 139 141 141 143 143 141 143 143 143 144 144 145 143 126
 137 138 137 139 138 139 140 139 140 141 141 144 143 143 142 122
 135 138 138 139 139 126 130 135 137 141 141 142 130 134 139 113

 111 104 104 120 121 119 112 118 113 108 106 104 114 121 110 110
 151 145 141 143 142 141 143 140 143 142 141 139 137 138 136 138
 150 142 146 144 141 141 142 143 141 143 141 139 138 137 131 131
 148 144 146 143 145 137 127 135 144 144 146 141 140 136 135 130
 146 144 143 141 146 116  49  93 142 143 141 139 138 139 130 139
 147 147 146 142 141  98  42  63 128 127 130 129 140 135 129 136
 148 145 142 140  99  45  45  42  50  55  52  76 138 133 132 130
 147 145 141 143 124  88  43  61  98 103  39  84 137 132 129 127
 144 146 145 144 145 118  45  93 141  76  48 138 137 133 131 127
 149 150 149 150 145 112  47  94  94  46 125 138 137 129 132 123
 153 150 148 145 147 104  47  58  47 115 140 134 133 129 128 115
 148 148 148 148 147 100  49  47  98 141 139 132 133 129 127 130
 150 150 143 149 148 132 107 106 140 143 142 129 136 131 129 135
 150 147 151 150 153 153 144 147 145 143 139 137 134 128 126 136
 148 149 151 149 152 149 147 147 145 140 138 136 134 128 125 137
 146 153 151 149 148 149 151 149 143 138 136 133 129 126 124 133
 132 128 131 143 142 137 131 136 145 138 132 129 135 138 133 121
 167 166 166 167 167 167 167 166 166 166 166 164 164 162 160 154
 168 167 166 167 168 168 167 166 167 167 167 164 164 162 161 152
 167 167 167 167 167 161 148 156 166 166 166 163 163 162 160 150
 168 168 167 168 166 121  49 100 165 166 166 165 164 161 160 156
 167 166 167 167 156 101  39  70 143 148 153 151 162 161 160 154
 167 167 168 169  98  47  40  44  48  46  46  80 161 160 159 152
 167 168 169 168 138  88  39  63 112 106  42  92 160 161 158 149
 170 170 169 168 167 122  41  94 157  76  60 157 160 160 158 145
 169 170 169 169 170 119  42  96  97  49 147 161 160 159 156 142
 168 169 170 170 169 111  44  54  44 131 163 161 160 159 155 140
 169 171 172 171 170 110  46  43 104 164 164 163 160 159 156 153
 168 172 172 171 170 150 117 120 164 166 164 161 159 158 155 151
 167 172 172 173 172 171 169 168 167 166 161 160 158 156 155 151
 170 172 173 173 171 170 169 168 167 165 161 160 157 155 154 151
 169 173 172 169 169 170 169 167 166 163 160 158 156 155 154 148
 124 119 118 127 126 126 121 123 135 130 123 118 121 126 122 113
 151 147 148 148 147 148 148 147 148 147 147 146 145 143 142 139
 151 149 148 148 149 149 147 147 148 148 148 146 145 145 143 134
 151 149 148 148 148 138 126 133 148 149 148 147 145 144 143 130
 151 149 149 150 147 110  36  89 150 147 148 147 145 144 144 142
 152 149 149 148 136  92  31  57 125 127 131 131 145 143 141 141
 152 150 150 149  80  34  28  32  32  28  34  71 142 143 141 141
 152 150 151 150 124  78  26  58 102  95  32  79 145 143 140 137
 152 151 151 150 148 104  31  85 136  63  47 141 142 141 139 135
 150 151 150 149 151 103  35  89  82  39 134 144 143 143 140 130
 152 150 151 151 150  96  31  48  34 118 148 144 143 143 139 126
 152 152 153 152 150  98  33  33  93 146 145 144 143 141 138 139
 153 153 152 152 150 134 106 101 147 147 146 145 142 141 139 139
 154 153 150 153 153 153 151 150 148 147 145 143 140 139 137 138
 156 154 154 152 153 151 151 150 149 147 143 142 140 138 138 138
 156 153 153 152 151 151 150 149 148 146 142 140 141 139 137 135

 110 138 131 130 139 136 130 127 127 123 115 130 135 136 137 133
 110 136 131 135 130 129 132 129 131 132 128 127 129 126 125 124
 121 138 137 136 139 135 133 132 133 129 129 129 131 128 128 126
 114 137 138 140 138 140 138 137 137 137 133 133 136 134 134 129
 104 139 139 141 139 129  76  84 138 138 134 132 129 137 136 133
 106 141 141 146 141 130  52  39  48 125 140 139 142 139 138 136
 108 142 143 144 143 127  55 103  76  46 115 141 143 143 140 138
 113 143 141 144 142 128  50  98 141  94  47  98 140 145 145 143
 118 140 143 135  93  63  42  61  93  94  58  47 106 147 147 149
 112 143 142 127  49  42  45  43  45  47  47  49 107 144 147 151
 119 141 141 137 116  98  45  88 118 112 104 100 132 153 149 149
 121 142 141 145 146 141  99 124 145 145 147 147 148 153 152 148
 120 143 144 143 141 142 140 143 144 150 145 148 149 150 149 149
 104 141 146 146 143 146 142 141 145 149 148 148 143 151 151 151
 104 145 142 144 144 147 145 145 146 150 150 148 150 147 149 153
 111 151 150 148 146 147 148 147 144 149 153 148 150 150 148 146
 121 154 152 150 156 154 152 149 145 142 140 153 151 151 151 148
 133 160 161 160 160 160 159 158 158 156 155 156 155 155 154 154
 138 162 162 162 161 161 160 161 160 159 159 159 158 156 155 155
 135 164 164 163 164 162 161 160 160 160 160 160 159 158 157 156
 129 164 164 163 165 151  80  92 157 161 161 163 161 160 160 158
 132 166 167 166 166 153  46  42  60 147 163 164 164 161 161 160
 138 166 167 166 166 148  46 106  76  49 131 164 166 166 165 163
 145 166 167 166 165 143  48 112 157  97  44 104 164 167 167 166
 136 166 166 156 100  70  44  63  94  96  54  43 120 168 168 167
 131 167 167 148  49  39  40  39  41  42  44  46 117 169 169 169
 137 167 168 161 121 101  47  88 122 119 111 110 150 171 170 170
 142 167 168 167 166 156  98 138 167 170 169 170 170 172 171 169
 143 167 167 167 168 167 169 168 168 169 170 171 171 173 173 169
 131 166 166 167 167 167 168 169 169 169 170 172 172 172 173 172
 128 166 167 167 168 166 167 168 170 170 169 171 172 172 172 173
 132 167 168 167 168 167 167 167 170 169 168 169 168 167 170 169
 113 139 134 130 142 141 141 137 135 130 126 139 139 138 138 135
 122 142 143 143 144 141 141 140 139 140 139 138 139 137 138 137
 126 143 145 144 144 143 143 143 141 143 143 141 141 139 138 139
 121 145 145 145 145 145 142 145 142 143 143 143 142 140 140 141
 118 146 146 147 147 131  71  79 141 144 144 144 145 143 142 140
 123 147 148 148 148 131  34  32  47 134 148 145 146 145 143 142
 130 147 148 149 147 127  28  95  63  39 118 146 147 147 147 146
 135 148 148 148 150 125  32 102 136  82  34  93 147 148 149 148
 123 147 147 133  89  57  32  58  85  89  48  33 101 150 150 149
 121 148 147 126  36  31  28  26  31  35  31  33 106 151 151 150
 126 148 149 138 110  92  34  78 104 103  96  98 134 153 151 151
 126 147 149 148 147 136  80 124 148 151 150 150 150 153 153 151
 127 148 148 148 150 148 149 150 150 149 151 152 152 153 152 152
 118 148 148 148 149 149 150 151 151 150 151 153 152 150 154 153
 119 147 149 149 149 149 150 150 151 151 150 152 153 153 154 153
 124 151 151 151 151 152 152 152 152 150 152 152 153 154 156 156

