 146 146 145 145 143 151 148 149 147 149 151 148 149 151 150 145
 150 146 146 147 146 150 152 150 149 151 150 151 152 151 151 150
 148 146 147 148 147 154 153 151 147 150 152 147 150 151 150 153
 143 144 144 146 146 141 129 119 121 136 148 151 149 151 151 151
 151 146 145 145 129  56  49  45  42  50 116 145 145 151 149 151
 155 148 145 144 131  64  92  98  77  45  66 149 148 149 144 147
 150 145 148 144 140 139 139 140 116  49  68 145 142 146 148 149
 153 145 142 144 147 140 110  53  46  62 125 140 143 146 146 145
 145 141 142 143 146 144 116  85  60  47  94 143 145 147 145 147
 142 144 142 145 143 142 144 142 145  48  46 139 145 143 144 148
 150 141 141 142 113  93 114 120  85  40  51 130 143 144 143 147
 151 140 142 141 109  43  41  42  40  48 103 143 139 143 143 145
 145 143 141 142 138 114 100  89 105 129 138 138 145 144 142 142
 141 142 140 140 143 142 142 142 143 142 142 141 143 141 143 138
 147 139 140 136 141 137 137 137 141 141 142 142 142 139 137 143
 129 125 128 130 133 124 131 131 132 127 127 130 128 135 118 133
 165 165 166 167 169 170 171 168 169 170 170 169 171 171 171 170
 164 167 168 168 170 171 170 169 170 172 172 172 171 172 173 171
 168 168 168 168 169 170 169 170 170 171 172 172 171 173 173 170
 167 167 168 168 167 161 149 138 142 161 169 171 171 172 170 168
 164 167 168 168 141  62  49  46  46  56 128 171 169 171 172 169
 167 168 168 167 145  72 104 113  86  42  65 169 169 170 171 168
 164 168 167 168 164 165 164 164 132  42  71 168 169 172 171 167
 164 166 167 167 167 168 125  64  49  60 144 167 168 171 170 167
 166 169 168 168 167 167 133  85  65  43  94 165 168 170 169 166
 163 166 167 167 165 166 166 166 153  42  46 162 167 168 167 165
 166 167 167 167 128 105 136 149 101  40  56 154 166 167 167 166
 166 166 166 165 115  46  44  42  42  49 113 166 166 166 167 165
 164 166 166 165 159 128 113 102 119 147 166 167 166 166 166 164
 166 166 167 166 166 165 166 166 165 166 166 166 165 166 165 161
 165 164 164 163 165 166 165 166 165 165 165 166 165 166 164 160
 152 155 157 153 157 151 157 154 157 154 155 156 151 158 150 151
 144 145 146 148 149 150 150 151 151 150 150 151 153 153 152 154
 149 149 150 149 150 153 152 150 152 153 153 153 153 154 154 155
 152 150 150 149 150 151 150 151 151 152 153 153 152 154 154 155
 150 148 150 150 149 143 135 127 125 142 152 152 152 153 152 156
 148 148 149 149 127  49  36  33  33  42 110 152 151 152 153 154
 149 149 149 148 127  58  89  98  76  34  59 154 150 150 152 151
 145 150 149 149 145 144 146 148 123  31  59 150 151 154 151 153
 151 151 149 149 148 149 114  55  36  51 130 148 150 152 150 152
 149 149 148 149 148 150 117  69  49  30  85 146 149 151 150 149
 147 147 149 148 147 147 146 147 146  30  38 147 149 149 150 150
 149 148 149 147 115  94 130 138 100  32  37 135 148 148 149 150
 146 148 148 148 109  34  35  36  37  37  92 146 148 148 149 150
 147 147 149 147 144 107  94  84 101 125 147 149 148 148 148 152
 151 148 148 147 147 148 147 147 147 147 148 148 148 147 148 149
 149 147 147 147 147 147 147 147 147 146 146 147 147 147 147 146
 139 141 143 140 144 134 141 140 144 138 139 141 140 143 136 141

 145 150 153 151 151 147 149 145 147 148 147 145 142 138 143 133
 150 151 150 151 149 144 148 146 145 144 143 143 142 143 137 118
 151 151 151 151 151 149 146 146 147 143 144 143 144 141 139 135
 149 152 150 149 145 148 142 143 145 145 143 139 145 143 142 128
 148 151 147 151 145 149 145 140 143 139 130 143 138 141 142 130
 151 150 152 148 116  66  68 125  94  46  51 103 138 142 142 127
 149 151 150 136  50  45  49  62  47  48  40  48 129 142 141 127
 147 149 147 121  42  77 116  46  60 145  85  40 105 143 141 132
 149 150 151 119  45  98 140  53  85 142 120  42  89 142 137 131
 148 152 153 129  49  92 139 110 116 144 114  41 100 142 137 131
 151 150 154 141  56  64 139 140 144 142  93  43 114 142 137 124
 143 146 147 146 129 131 140 147 146 143 113 109 138 143 141 133
 145 147 148 146 145 144 144 144 143 145 142 141 142 140 136 130
 145 146 147 144 145 145 148 142 142 142 141 142 141 140 140 128
 146 146 146 144 146 148 145 145 141 144 141 140 143 142 139 125
 146 150 148 143 151 155 150 153 145 142 150 151 145 141 147 129
 170 171 170 168 169 168 167 167 166 165 166 165 164 161 160 151
 171 173 173 170 172 171 171 170 169 167 167 167 166 165 164 150
 171 172 173 172 171 170 172 171 170 168 167 166 166 166 166 158
 171 171 171 171 169 169 169 168 168 167 166 166 166 165 165 151
 169 172 172 171 171 169 168 167 165 162 154 166 167 166 166 156
 170 172 172 169 128  65  71 144  94  46  56 113 166 166 165 155
 170 172 171 161  56  42  42  60  43  42  40  49 147 166 165 154
 169 170 170 142  46  86 132  49  65 153 101  42 119 165 165 157
 168 169 170 138  46 113 164  64  85 166 149  42 102 166 166 154
 171 170 169 149  49 104 164 125 133 166 136  44 113 166 165 157
 170 171 170 161  62  72 165 168 167 166 105  46 128 165 166 151
 169 170 169 167 141 145 164 167 167 165 128 115 159 166 165 157
 167 168 168 168 168 167 168 167 168 167 167 165 165 166 163 153
 166 168 168 168 168 168 167 167 168 167 167 166 166 167 164 157
 165 167 168 167 167 168 168 166 169 166 167 166 166 166 164 155
 165 164 168 167 164 167 164 164 166 163 166 166 164 166 165 152
 154 155 155 156 154 151 153 152 149 150 150 150 152 149 146 141
 152 154 154 152 153 152 151 150 150 150 149 149 148 148 147 136
 153 154 154 153 152 150 154 152 151 149 148 148 148 147 147 143
 153 153 152 152 151 150 151 150 149 149 148 148 148 148 147 140
 151 153 153 152 152 154 150 148 146 147 135 146 149 148 147 141
 150 153 153 152 110  59  59 130  85  38  37  92 147 148 146 139
 150 153 152 142  42  34  31  51  30  30  32  37 125 147 146 138
 151 152 151 125  33  76 123  36  49 146 100  37 101 147 147 144
 151 150 151 127  33  98 148  55  69 147 138  36  84 147 147 140
 150 152 150 135  36  89 146 114 117 146 130  35  94 147 147 141
 150 153 151 143  49  58 144 149 150 147  94  34 107 148 147 134
 149 150 150 149 127 127 145 148 148 147 115 109 144 147 147 144
 148 149 149 150 149 148 149 149 149 148 147 148 147 147 147 140
 146 150 150 150 149 149 149 149 148 149 149 148 149 148 147 143
 145 149 150 148 148 149 150 151 149 147 148 148 147 148 147 141
 144 149 152 150 148 149 145 151 149 147 149 146 147 151 149 139

 133 118 135 128 130 127 127 132 131 131 124 133 130 128 125 129
 143 137 139 142 142 142 141 141 137 137 137 141 136 140 139 147
 138 143 141 143 141 142 142 143 142 142 142 143 140 140 142 141
 142 142 144 145 138 138 129 105  89 100 114 138 142 141 143 145
 145 143 143 139 143 103  48  40  42  41  43 109 141 142 140 151
 147 143 144 143 130  51  40  85 120 114  93 113 142 141 141 150
 148 144 143 145 139  46  48 145 142 144 142 143 145 142 144 142
 147 145 147 145 143  94  47  60  85 116 144 146 143 142 141 145
 145 146 146 143 140 125  62  46  53 110 140 147 144 142 145 153
 149 148 146 142 145  68  49 116 140 139 139 140 144 148 145 150
 147 144 149 148 149  66  45  77  98  92  64 131 144 145 148 155
 151 149 151 145 145 116  50  42  45  49  56 129 145 145 146 151
 151 151 151 149 151 148 136 121 119 129 141 146 146 144 144 143
 153 150 151 150 147 152 150 147 151 153 154 147 148 147 146 148
 150 151 151 152 151 150 151 149 150 152 150 146 147 146 146 150
 145 150 151 149 148 151 149 147 149 148 151 143 145 145 146 146
 151 150 158 151 156 155 154 157 154 157 151 157 153 157 155 152
 160 164 166 165 166 165 165 165 166 165 166 165 163 164 164 165
 161 165 166 165 166 166 166 165 166 166 165 166 166 167 166 166
 164 166 166 166 167 166 147 119 102 113 128 159 165 166 166 164
 165 167 166 166 166 113  49  42  42  44  46 115 165 166 166 166
 166 167 167 166 154  56  40 101 149 136 105 128 167 167 167 166
 165 167 168 167 162  46  42 153 166 166 166 165 167 167 166 163
 166 169 170 168 165  94  43  65  85 133 167 167 168 168 169 166
 167 170 171 168 167 144  60  49  64 125 168 167 167 167 166 164
 167 171 172 169 168  71  42 132 164 164 165 164 168 167 168 164
 168 171 170 169 169  65  42  86 113 104  72 145 167 168 168 167
 169 172 171 169 171 128  56  46  46  49  62 141 168 168 167 164
 168 170 172 171 171 169 161 142 138 149 161 167 168 168 167 167
 170 173 173 171 172 172 171 170 170 169 170 169 168 168 168 168
 171 173 172 171 172 172 172 170 169 170 171 170 168 168 167 164
 170 171 171 171 169 170 170 169 168 171 170 169 167 166 165 165
 141 136 143 140 141 139 138 144 140 141 134 144 140 143 141 139
 146 147 147 147 147 146 146 147 147 147 147 147 147 147 147 149
 149 148 147 148 148 148 147 147 147 147 148 147 147 148 148 151
 152 148 148 148 149 147 125 101  84  94 107 144 147 149 147 147
 150 149 148 148 146  92  37  37  36  35  34 109 148 148 148 146
 150 149 148 148 135  37  32 100 138 130  94 115 147 149 148 149
 150 150 149 149 147  38  30 146 147 146 147 147 148 149 147 147
 149 150 151 149 146  85  30  49  69 117 150 148 149 148 149 149
 152 150 152 150 148 130  51  36  55 114 149 148 149 149 151 151
 153 151 154 151 150  59  31 123 148 146 144 145 149 149 150 145
 151 152 150 150 154  59  34  76  98  89  58 127 148 149 149 149
 154 153 152 151 152 110  42  33  33  36  49 127 149 149 148 148
 156 152 153 152 152 152 142 125 127 135 143 149 150 150 148 150
 155 154 154 152 153 153 152 151 151 150 151 150 149 150 150 152
 155 154 154 153 153 153 153 152 150 152 153 150 149 150 149 149
 154 152 153 153 151 150 150 151 151 150 150 149 148 146 145 144

 129 147 141 145 151 150 142 145 153 150 155 151 143 148 150 146
 125 139 142 143 140 141 144 141 145 145 148 146 144 146 146 146
 128 140 140 141 142 141 142 142 142 148 145 145 144 147 146 145
 130 136 140 142 141 142 145 143 144 144 144 145 146 148 147 145
 133 141 143 138 109 113 143 146 147 140 131 129 146 147 146 143
 124 137 142 114  43  93 142 144 140 139  64  56 141 154 150 151
 131 137 142 100  41 114 144 116 110 139  92  49 129 153 152 148
 131 137 142  89  42 120 142  85  53 140  98  45 119 151 150 149
 132 141 143 105  40  85 145  60  46 116  77  42 121 147 149 147
 127 141 142 129  48  40  48  47  62  49  45  50 136 150 151 149
 127 142 142 138 103  51  46  94 125  68  66 116 148 152 150 151
 130 142 141 138 143 130 139 143 140 145 149 145 151 147 151 148
 128 142 143 145 139 143 145 145 143 142 148 145 149 150 152 149
 135 139 141 144 143 144 143 147 146 146 149 151 151 151 151 151
 118 137 143 142 143 143 144 145 146 148 144 149 151 150 151 150
 133 143 138 142 145 147 148 147 145 149 147 151 151 153 150 145
 152 165 166 164 166 166 163 166 164 164 167 164 167 168 164 165
 155 164 166 166 166 167 166 169 166 168 168 167 167 168 167 165
 157 164 167 166 166 167 167 168 167 167 168 168 168 168 168 166
 153 163 166 165 165 167 167 168 167 168 167 168 168 168 168 167
 157 165 166 159 115 128 165 167 167 164 145 141 167 169 170 169
 151 166 165 128  46 105 166 167 168 165  72  62 161 170 171 170
 157 165 166 113  44 136 166 133 125 164 104  49 149 169 170 171
 154 166 166 102  42 149 166  85  64 164 113  46 138 170 169 168
 157 165 165 119  42 101 153  65  49 132  86  46 142 170 170 169
 154 165 166 147  49  40  42  43  60  42  42  56 161 171 172 170
 155 165 166 166 113  56  46  94 144  71  65 128 169 172 172 170
 156 166 166 167 166 154 162 165 167 168 169 171 171 172 172 169
 151 165 165 166 166 166 167 168 168 169 169 169 171 171 171 171
 158 166 166 166 166 167 168 170 171 172 170 171 172 173 172 171
 150 164 165 166 167 167 167 169 170 171 171 172 170 173 173 171
 151 160 161 164 165 166 165 166 167 167 168 169 168 170 171 170
 139 149 151 147 146 149 147 149 151 145 149 148 150 152 149 144
 141 147 148 147 148 148 147 149 151 150 149 148 148 150 149 145
 143 147 148 149 148 149 149 148 149 149 149 149 150 150 150 146
 140 147 147 147 148 147 148 149 149 149 148 149 150 149 149 148
 144 147 147 144 109 115 147 148 148 145 127 127 149 150 150 149
 134 147 148 107  34  94 147 150 149 144  58  49 143 151 153 150
 141 147 147  94  35 130 146 117 114 146  89  36 135 150 152 150
 140 147 147  84  36 138 147  69  55 148  98  33 127 151 150 151
 144 147 147 101  37 100 146  49  36 123  76  33 125 151 152 151
 138 146 147 125  37  32  30  30  51  31  34  42 142 152 153 150
 139 146 148 147  92  37  38  85 130  59  59 110 152 153 153 150
 141 147 148 149 146 135 147 146 148 150 154 152 152 153 153 151
 140 147 148 148 148 148 149 149 150 151 150 151 152 152 153 153
 143 147 147 148 148 148 149 151 152 154 150 152 153 154 154 153
 136 147 148 148 149 149 150 150 150 151 152 153 152 154 154 152
 141 146 149 152 150 150 150 149 152 153 151 154 156 155 155 154

