 132 138 132 132 134 129 142 137 138 141 141 149 147 149 149 148
 133 136 135 139 138 140 140 143 143 144 147 147 148 150 148 148
 137 138 137 140 141 140 142 143 141 145 146 146 148 149 148 150
 135 133 138 139 141 141 141 137 138 145 145 147 147 148 147 147
 139 136 137 138 138 138 124  51  58 145 146 146 145 147 147 145
 137 140 141 139 140  76  49  43  44 149 147 147 148 146 149 147
 142 138 141 139 141  91  80  48  47 147 146 145 148 148 146 145
 137 137 139 141 140 139 124  40  45 144 147 145 147 148 146 152
 136 138 139 140 142 142 131  37  50 140 150 143 146 147 146 146
 139 138 138 138 140 141 126  35  43 150 143 146 146 145 146 146
 140 136 136 138 138 132 124  37  45 137 144 144 144 146 145 150
 136 139 140 140 138  64  41  43  39  53  77 144 145 144 144 145
 141 138 141 142 142 100  91  96  96  92 115 146 146 147 147 149
 141 139 141 143 142 142 142 144 144 142 143 144 144 148 145 142
 141 135 140 141 140 141 144 142 144 144 143 143 145 145 143 146
 133 131 136 139 137 138 138 135 140 141 141 139 140 141 141 139
 151 156 155 155 158 156 161 160 160 163 162 166 166 166 166 162
 158 160 160 161 161 162 163 164 166 167 166 168 168 168 169 165
 158 160 161 161 161 163 163 165 167 166 166 167 168 168 169 166
 159 160 160 162 162 162 162 162 160 165 166 166 168 168 167 167
 160 160 160 161 161 159 145  53  59 164 167 167 169 167 167 164
 158 160 161 162 162  79  46  37  42 163 166 168 168 168 167 166
 159 160 161 162 162  96  84  40  45 161 167 167 168 168 168 163
 159 160 161 161 163 163 140  38  40 163 167 168 167 167 168 167
 159 161 162 162 164 164 144  37  45 161 166 167 168 168 168 164
 159 162 162 163 164 165 141  36  40 166 166 167 168 168 168 165
 160 162 162 163 163 161 137  36  44 155 163 167 168 166 167 164
 161 162 162 162 162  65  44  36  37  54  88 165 168 167 167 164
 161 162 162 164 164 108 101 104 104 104 132 165 167 166 166 166
 162 162 163 163 165 165 165 165 166 166 167 166 167 167 166 159
 161 162 162 163 164 164 165 166 166 166 166 167 166 166 166 163
 158 159 159 158 162 160 160 160 162 162 163 162 161 162 161 156
 136 139 137 137 141 139 144 143 142 147 146 148 148 148 151 153
 142 143 143 143 144 145 145 147 148 148 149 149 150 150 152 150
 144 142 143 143 144 144 145 147 148 149 149 149 149 149 150 151
 145 144 143 143 145 146 145 146 145 147 149 149 150 150 149 152
 145 143 143 144 146 141 132  40  48 149 149 149 150 151 150 152
 144 143 144 144 145  66  39  30  33 148 149 149 149 150 151 153
 143 143 145 144 147  79  71  26  37 148 150 149 149 149 149 148
 144 143 146 145 146 147 128  24  34 149 148 151 150 150 150 152
 148 145 145 145 146 145 133  27  33 148 150 149 149 149 149 151
 146 145 144 146 148 148 127  28  29 152 149 150 149 149 149 154
 146 144 145 146 145 142 125  25  38 141 146 149 149 149 149 151
 146 146 145 146 147  54  36  26  29  45  75 148 149 149 149 148
 147 144 146 148 147  93  87  87  85  90 112 149 149 148 149 151
 146 145 147 147 148 148 149 148 148 149 150 150 149 148 148 147
 145 145 145 146 146 147 147 149 148 149 149 149 149 148 149 154
 146 141 142 145 146 144 146 144 147 147 146 145 149 146 145 142

 148 148 150 147 145 147 145 152 146 146 150 145 149 142 146 139
 149 148 148 147 147 149 146 146 146 146 145 144 147 145 143 141
 149 150 149 148 147 146 148 148 147 145 146 144 147 148 145 141
 147 148 148 147 145 148 148 147 146 146 144 145 146 144 145 140
 149 147 146 147 146 147 145 145 143 146 144 144 146 144 143 139
 141 147 146 145 146 147 146 147 150 143 144  77 115 143 143 141
 141 144 145 145 145 149 147 144 140 150 137  53  92 142 144 141
 138 143 141 138  58  44  47  45  50  43  45  39  96 144 144 140
 137 143 143 137  51  43  48  40  37  35  37  43  96 144 142 135
 142 140 142 141 124  49  80 124 131 126 124  41  91 142 144 138
 129 140 140 141 138  76  91 139 142 141 132  64 100 142 141 138
 134 138 141 141 138 140 141 140 142 140 138 138 142 142 140 137
 132 139 140 139 138 139 139 141 140 138 138 140 142 143 141 139
 132 135 137 138 137 141 141 139 139 138 136 140 141 141 140 136
 138 136 138 133 136 140 138 137 138 138 136 139 138 139 135 131
 132 133 137 135 139 137 142 137 136 139 140 136 141 141 141 133
 162 165 166 167 164 166 163 167 164 165 164 164 166 159 163 156
 166 169 169 167 167 167 168 168 168 168 167 167 166 166 166 161
 166 168 168 168 167 168 168 167 168 168 166 167 166 167 166 162
 166 168 168 168 169 168 168 167 168 168 168 168 167 167 166 161
 166 168 167 166 167 168 167 168 167 167 167 165 165 166 167 162
 162 166 166 166 167 166 167 167 166 166 163  88 132 167 166 163
 163 167 166 165 164 163 161 163 161 166 155  54 104 166 166 162
 160 166 167 160  59  42  45  40  45  40  44  37 104 166 166 162
 160 164 165 162  53  37  40  38  37  36  36  36 104 165 166 160
 161 163 163 162 145  46  84 140 144 141 137  44 101 165 165 160
 156 162 163 162 159  79  96 163 164 165 161  65 108 165 164 160
 158 161 161 162 161 162 162 163 164 164 163 162 164 165 164 162
 155 161 161 162 161 162 162 161 162 163 163 162 164 163 163 158
 155 160 161 160 160 161 161 161 162 162 162 162 162 163 162 159
 156 160 160 160 160 160 160 160 161 162 162 162 162 162 162 159
 151 158 158 159 160 158 159 159 159 159 160 161 161 162 161 158
 153 150 151 152 152 153 148 152 151 154 151 148 151 147 154 142
 151 152 150 149 150 151 149 150 149 149 149 149 149 148 149 145
 148 150 149 150 151 150 149 150 149 149 149 149 148 148 148 146
 148 150 149 150 150 149 149 150 149 149 149 149 149 149 149 149
 148 149 149 149 149 149 149 151 149 150 149 148 149 150 149 145
 146 149 149 149 149 149 150 148 150 149 146  75 112 150 149 146
 147 148 149 147 149 148 148 149 148 152 141  45  90 149 149 147
 142 148 148 145  48  33  37  34  33  29  38  29  85 148 148 147
 143 147 147 146  40  30  26  24  27  28  25  26  87 148 149 144
 144 145 145 145 132  39  71 128 133 127 125  36  87 149 147 146
 139 145 144 146 141  66  79 147 145 148 142  54  93 148 147 144
 141 144 144 145 146 145 147 146 146 148 145 147 147 148 146 146
 137 143 143 143 144 144 144 145 145 146 146 146 148 147 146 145
 137 143 143 143 143 144 145 146 145 144 145 145 146 147 145 142
 139 143 142 144 143 143 143 143 145 145 144 146 144 145 145 141
 136 142 144 145 145 144 143 144 148 146 146 146 147 146 145 146

 139 141 141 140 139 141 141 140 135 138 138 137 139 136 131 133
 146 143 145 145 143 143 144 144 142 144 141 140 141 140 135 141
 142 145 148 144 144 143 142 144 144 142 142 142 143 141 139 141
 149 147 147 146 146 115  92  96  96  91 100 142 142 141 138 141
 145 144 144 145 144  77  53  39  43  41  64 138 140 140 139 136
 150 145 146 144 144 144 137  45  37 124 132 138 138 136 136 140
 146 146 145 146 146 143 150  43  35 126 141 140 138 138 138 139
 146 146 147 146 143 150 140  50  37 131 142 142 140 139 138 136
 152 146 148 147 145 147 144  45  40 124 139 140 141 139 137 137
 145 146 148 148 145 146 147  47  48  80  91 141 139 141 138 142
 147 149 146 148 147 147 149  44  43  49  76 140 139 141 140 137
 145 147 147 145 146 146 145  58  51 124 138 138 138 137 136 139
 147 147 148 147 147 145 145 138 137 141 141 141 139 138 133 135
 150 148 149 148 146 146 145 141 143 142 140 141 140 137 138 137
 148 148 150 148 147 147 144 143 143 140 140 138 139 135 136 133
 148 149 149 147 149 141 141 138 137 142 129 134 132 132 138 132
 156 161 162 161 162 163 162 162 160 160 160 162 158 159 159 158
 163 166 166 166 167 166 166 166 166 165 164 164 163 162 162 161
 159 166 167 167 166 167 166 166 165 165 165 165 163 163 162 162
 166 166 166 167 165 132 104 104 104 101 108 164 164 162 162 161
 164 167 167 168 165  88  54  37  36  44  65 162 162 162 162 161
 164 167 166 168 167 163 155  44  36 137 161 163 163 162 162 160
 165 168 168 168 167 166 166  40  36 141 165 164 163 162 162 159
 164 168 168 168 167 166 161  45  37 144 164 164 162 162 161 159
 167 168 167 167 168 167 163  40  38 140 163 163 161 161 160 159
 163 168 168 168 167 167 161  45  40  84  96 162 162 161 160 159
 166 167 168 168 168 166 163  42  37  46  79 162 162 161 160 158
 164 167 167 169 167 167 164  59  53 145 159 161 161 160 160 160
 167 167 168 168 166 166 165 160 162 162 162 162 162 160 160 159
 166 169 168 168 167 166 166 167 165 163 163 161 161 161 160 158
 165 169 168 168 168 166 167 166 164 163 162 161 161 160 160 158
 162 166 166 166 166 162 163 160 160 161 156 158 155 155 156 151
 142 145 146 149 145 146 147 147 144 146 144 146 145 142 141 146
 154 149 148 149 149 149 149 148 149 147 147 146 146 145 145 145
 147 148 148 149 150 150 149 148 148 149 148 148 147 147 145 146
 151 149 148 149 149 112  90  85  87  87  93 147 148 146 144 147
 148 149 149 149 148  75  45  29  26  36  54 147 146 145 146 146
 151 149 149 149 149 146 141  38  25 125 142 145 146 145 144 146
 154 149 149 149 150 149 152  29  28 127 148 148 146 144 145 146
 151 149 149 149 149 150 148  33  27 133 145 146 145 145 145 148
 152 150 150 150 151 148 149  34  24 128 147 146 145 146 143 144
 148 149 149 149 149 150 148  37  26  71  79 147 144 145 143 143
 153 151 150 149 149 149 148  33  30  39  66 145 144 144 143 144
 152 150 151 150 149 149 149  48  40 132 141 146 144 143 143 145
 152 149 150 150 149 149 147 145 146 145 146 145 143 143 144 145
 151 150 149 149 149 149 149 148 147 145 144 144 143 143 142 144
 150 152 150 150 149 149 148 148 147 145 145 144 143 143 143 142
 153 151 148 148 148 146 147 142 143 144 139 141 137 137 139 136

 133 141 141 141 136 140 139 136 137 142 137 139 135 137 133 132
 131 135 139 138 139 136 138 138 137 138 140 136 133 138 136 138
 136 140 141 141 140 136 138 139 139 141 141 137 138 137 135 132
 139 141 143 142 140 138 138 140 141 139 139 138 139 140 139 132
 137 140 142 142 138 138 140 142 140 141 140 138 141 141 138 134
 138 141 142 100  64 132 141 142 139  91  76 138 141 140 140 129
 138 144 142  91  41 124 126 131 124  80  49 124 141 142 140 142
 135 142 144  96  43  37  35  37  40  48  43  51 137 143 143 137
 140 144 144  96  39  45  43  50  45  47  44  58 138 141 143 138
 141 144 142  92  53 137 150 140 144 147 149 145 145 145 144 141
 141 143 143 115  77 144 143 150 147 146 147 146 145 146 147 141
 139 143 144 146 144 144 146 143 145 145 147 146 147 146 147 149
 140 145 144 146 145 144 146 146 147 148 148 145 147 148 148 147
 141 145 148 147 144 146 145 147 148 148 146 147 148 149 150 149
 141 143 145 147 144 145 146 146 146 146 149 147 147 148 148 149
 139 146 142 149 145 150 146 146 152 145 147 145 147 150 148 148
 158 161 162 161 161 160 159 159 159 159 158 160 159 158 158 151
 159 162 162 162 162 162 162 161 160 160 160 160 160 160 160 156
 159 162 163 162 162 162 162 162 161 161 161 160 160 161 160 155
 158 163 163 164 162 163 163 162 161 162 162 161 162 161 161 155
 162 164 165 164 162 163 164 164 163 162 162 161 162 161 161 158
 160 164 165 108  65 161 165 164 163  96  79 159 162 163 162 156
 160 165 165 101  44 137 141 144 140  84  46 145 162 163 163 161
 160 166 165 104  36  36  36  37  38  40  37  53 162 165 164 160
 162 166 166 104  37  44  40  45  40  45  42  59 160 167 166 160
 162 166 166 104  54 155 166 161 163 161 163 164 165 166 167 163
 163 166 167 132  88 163 166 166 167 167 166 167 166 166 166 162
 162 167 166 165 165 167 167 167 168 167 168 167 166 167 168 166
 161 166 167 167 168 168 168 168 167 168 168 169 168 168 168 166
 162 166 167 166 167 166 168 168 167 168 168 167 168 168 168 166
 161 166 166 166 167 167 168 168 168 168 167 167 167 169 169 166
 156 163 159 166 164 164 165 164 167 163 166 164 167 166 165 162
 146 145 146 147 146 146 146 148 144 143 144 145 145 144 142 136
 141 145 145 144 146 144 145 145 143 143 143 143 144 142 143 139
 142 145 147 146 145 145 144 145 146 145 144 143 143 143 143 137
 145 146 147 148 146 146 146 145 145 144 144 144 143 143 143 137
 146 146 148 147 147 145 148 146 146 147 145 146 145 144 144 141
 144 147 148  93  54 142 148 145 147  79  66 141 146 144 145 139
 146 147 149  87  36 125 127 133 128  71  39 132 145 145 145 144
 144 149 148  87  26  25  28  27  24  26  30  40 146 147 147 143
 147 148 148  85  29  38  29  33  34  37  33  48 145 148 148 142
 147 149 149  90  45 141 152 148 149 148 148 149 147 149 148 147
 146 149 150 112  75 146 149 150 148 150 149 149 149 149 149 146
 145 149 150 149 148 149 150 149 151 149 149 149 149 149 149 148
 149 149 149 149 149 149 149 149 150 149 149 150 150 149 150 148
 146 148 148 148 149 149 149 149 150 149 150 151 150 149 150 148
 145 149 148 149 149 149 149 149 150 149 151 150 149 150 152 151
 142 154 147 151 148 151 154 151 152 148 153 152 152 151 150 153

