 135 129 126 130 133 133 133 136 141 144 146 145 148 149 149 148
 133 128 133 132 131 136 140 141 145 148 148 149 150 150 149 156
 137 130 134 132 135 131 140 141 137 139 150 150 154 152 153 155
 138 131 131 134 135 125  92  67  53  62 127 148 152 151 153 153
 128 129 133 132 128  62  45  57  79  77 136 152 151 151 147 151
 129 132 134 135 101  39  63 142 144 144 150 151 152 153 153 151
 135 126 133 136  67  45  70  56  53  77 137 148 149 151 154 153
 136 130 132 140  61  36  67  90  51  47  70 151 152 152 154 151
 132 132 136 142  59  39 122 142 124  37  46 153 151 152 154 154
 140 133 137 138  71  43 107 144 112  40  65 158 153 151 153 154
 135 136 141 141 117  44  44  86  59  47 105 150 151 151 156 160
 138 134 138 142 144 118  76  60  72 114 149 152 150 150 151 157
 142 134 142 141 142 143 142 144 148 144 148 152 152 151 151 149
 142 140 144 144 144 145 146 146 152 150 151 148 148 151 151 154
 140 141 142 141 143 147 149 145 147 148 151 151 148 149 151 150
 113 114 123 124 107 116 125 129 134 123 123 124 125 127 120 112
 153 156 157 158 160 161 163 166 166 168 169 171 171 171 173 170
 154 158 158 159 161 162 163 166 168 169 172 173 173 174 174 172
 153 158 160 160 160 163 164 163 165 168 171 173 173 174 174 173
 156 159 160 161 161 157 114  77  63  67 144 174 174 174 174 173
 154 159 160 161 155  81  42  58  83  83 147 173 174 175 175 174
 153 160 160 161 118  39  60 159 166 167 172 174 175 175 175 175
 156 161 160 161  77  38  76  70  62  92 157 174 175 175 175 173
 159 161 161 162  68  38  66  97  60  40  79 173 174 174 174 173
 153 161 161 163  62  38 132 169 135  37  46 168 176 175 176 175
 158 161 162 164  79  39 113 166 129  40  63 173 175 176 176 174
 162 162 165 165 136  48  48  94  63  45 116 174 176 175 175 175
 158 163 165 167 167 134  86  67  79 127 173 176 175 176 176 173
 161 164 165 167 169 170 169 168 172 174 175 175 177 175 175 173
 162 164 166 168 170 171 171 173 172 173 175 175 176 175 176 173
 159 164 166 167 168 169 171 172 173 173 174 174 175 175 174 165
 132 142 148 153 139 142 148 152 158 147 143 146 150 156 144 134
 140 137 138 139 140 142 143 146 148 149 149 151 153 150 152 154
 138 140 141 142 143 143 145 147 149 150 152 154 153 154 153 160
 139 141 141 143 144 146 147 145 147 149 152 153 154 154 154 160
 142 141 143 142 143 138 102  67  51  54 127 154 153 154 155 156
 139 141 141 142 138  66  27  41  72  66 128 154 155 156 156 158
 139 141 141 143 105  26  52 142 145 146 149 154 154 156 155 158
 142 141 143 145  64  25  65  59  55  80 137 153 153 155 153 158
 142 142 143 146  60  30  54  75  45  33  63 151 152 154 155 159
 138 142 144 146  51  26 123 151 127  32  39 150 153 154 154 156
 143 142 144 145  66  26 102 146 117  32  51 152 153 153 156 157
 143 144 145 146 112  29  39  90  55  31  95 154 154 156 154 155
 140 144 145 147 149 115  65  51  57 105 152 153 153 155 155 155
 145 145 146 148 150 150 149 148 149 152 153 153 155 155 155 160
 144 146 147 148 150 152 152 153 151 154 155 154 154 155 155 160
 145 144 147 147 149 150 150 152 153 153 154 155 154 154 155 151
 126 127 133 138 126 132 136 138 144 129 124 132 138 142 130 126

 148 156 155 153 151 151 153 151 154 154 160 157 149 154 150 112
 149 149 153 153 147 153 154 154 154 153 156 151 151 151 151 120
 149 150 152 151 151 153 151 152 152 151 151 150 151 151 149 127
 148 150 154 152 151 152 149 152 151 153 151 150 152 148 148 125
 145 149 150 148 152 151 148 151 153 158 150 152 152 148 151 124
 146 148 150 127 136 150 137  70  46  65 105 149 148 151 151 123
 144 148 139  62  77 144  77  47  37  40  47 114 144 150 148 123
 141 145 137  53  79 144  53  51 124 112  59  72 148 152 147 134
 136 141 141  67  57 142  56  90 142 144  86  60 144 146 145 129
 133 140 140  92  45  63  70  67 122 107  44  76 142 146 149 125
 133 136 131 125  62  39  45  36  39  43  44 118 143 145 147 116
 133 131 135 135 128 101  67  61  59  71 117 144 142 144 143 107
 130 132 132 134 132 135 136 140 142 138 141 142 141 144 141 124
 126 133 134 131 133 134 133 132 136 137 141 138 142 144 142 123
 129 128 130 131 129 132 126 130 132 133 136 134 134 140 141 114
 135 133 137 138 128 129 135 136 132 140 135 138 142 142 140 113
 170 172 173 173 174 175 173 173 175 174 175 173 173 173 165 134
 173 174 174 174 175 175 175 174 176 176 175 176 175 176 174 144
 171 174 174 174 175 175 175 174 175 176 175 176 175 175 175 156
 171 173 173 174 174 175 175 174 176 175 176 175 177 176 175 150
 171 173 173 174 173 174 174 173 168 173 174 176 175 175 174 146
 169 172 171 144 147 172 157  79  46  63 116 173 175 175 174 143
 168 169 168  67  83 167  92  40  37  40  45 127 174 173 173 147
 166 168 165  63  83 166  62  60 135 129  63  79 172 172 173 158
 166 166 163  77  58 159  70  97 169 166  94  67 168 173 172 152
 163 163 164 114  42  60  76  66 132 113  48  86 169 171 171 148
 161 162 163 157  81  39  38  38  38  39  48 134 170 171 169 142
 160 161 160 161 155 118  77  68  62  79 136 167 169 170 168 139
 158 159 160 161 161 161 161 162 163 164 165 167 167 168 167 153
 157 158 160 160 160 160 160 161 161 162 165 165 165 166 166 148
 156 158 158 159 159 160 161 161 161 161 162 163 164 164 164 142
 153 154 153 156 154 153 156 159 153 158 162 158 161 162 159 132
 154 160 160 156 158 158 158 159 156 157 155 155 160 160 151 126
 152 153 154 155 156 155 153 155 154 156 154 155 155 155 155 130
 150 154 154 154 156 156 155 154 154 153 156 155 155 155 154 142
 153 153 154 153 155 154 153 152 153 153 154 153 155 154 154 138
 151 154 153 154 154 154 153 151 150 152 154 153 153 154 155 132
 149 152 152 127 128 149 137  63  39  51  95 152 153 155 154 124
 149 150 149  54  66 146  80  33  32  32  31 105 152 154 153 129
 148 149 147  51  72 145  55  45 127 117  55  57 149 151 153 144
 146 147 145  67  41 142  59  75 151 146  90  51 148 153 152 138
 143 145 147 102  27  52  65  54 123 102  39  65 149 152 150 136
 142 143 146 138  66  26  25  30  26  26  29 115 150 152 150 132
 140 143 144 143 138 105  64  60  51  66 112 149 150 150 149 126
 139 142 143 142 142 143 145 146 146 145 146 147 148 148 147 138
 138 141 141 143 141 141 143 143 144 144 145 145 146 147 147 133
 137 140 141 141 141 141 141 142 142 142 144 144 145 146 144 127
 140 138 139 142 139 139 142 142 138 143 143 140 145 144 145 126

 112 120 127 125 124 123 123 134 129 125 116 107 124 123 114 113
 150 151 149 148 151 151 148 147 145 149 147 143 141 142 141 140
 154 151 151 148 148 151 150 152 146 146 145 144 144 144 140 142
 149 151 151 152 152 148 144 148 144 142 143 142 141 142 134 142
 157 151 150 150 152 149 114  72  60  76 118 144 142 138 134 138
 160 156 151 151 150 105  47  59  86  44  44 117 141 141 136 135
 154 153 151 153 158  65  40 112 144 107  43  71 138 137 133 140
 154 154 152 151 153  46  37 124 142 122  39  59 142 136 132 132
 151 154 152 152 151  70  47  51  90  67  36  61 140 132 130 136
 153 154 151 149 148 137  77  53  56  70  45  67 136 133 126 135
 151 153 153 152 151 150 144 144 142  63  39 101 135 134 132 129
 151 147 151 151 152 136  77  79  57  45  62 128 132 133 129 128
 153 153 151 152 148 127  62  53  67  92 125 135 134 131 131 138
 155 153 152 154 150 150 139 137 141 140 131 135 132 134 130 137
 156 149 150 150 149 148 148 145 141 140 136 131 132 133 128 133
 148 149 149 148 145 146 144 141 136 133 133 133 130 126 129 135
 134 144 156 150 146 143 147 158 152 148 142 139 153 148 142 132
 165 174 175 175 174 174 173 173 172 171 169 168 167 166 164 159
 173 176 175 176 175 175 173 172 173 171 171 170 168 166 164 162
 173 175 175 177 175 175 174 172 168 169 170 169 167 165 164 161
 173 176 176 175 176 173 127  79  67  86 134 167 167 165 163 158
 175 175 175 176 174 116  45  63  94  48  48 136 165 165 162 162
 174 176 176 175 173  63  40 129 166 113  39  79 164 162 161 158
 175 176 175 176 168  46  37 135 169 132  38  62 163 161 161 153
 173 174 174 174 173  79  40  60  97  66  38  68 162 161 161 159
 173 175 175 175 174 157  92  62  70  76  38  77 161 160 161 156
 175 175 175 175 174 172 167 166 159  60  39 118 161 160 160 153
 174 175 175 174 173 147  83  83  58  42  81 155 161 160 159 154
 173 174 174 174 174 144  67  63  77 114 157 161 161 160 159 156
 173 174 174 173 173 171 168 165 163 164 163 160 160 160 158 153
 172 174 174 173 173 172 169 168 166 163 162 161 159 158 158 154
 170 173 171 171 171 169 168 166 166 163 161 160 158 157 156 153
 126 130 142 138 132 124 129 144 138 136 132 126 138 133 127 126
 151 155 154 154 155 154 153 153 152 150 150 149 147 147 144 145
 160 155 155 154 154 155 154 151 153 152 152 150 148 147 146 144
 160 155 155 155 153 153 152 149 148 149 150 150 148 146 145 145
 155 155 155 153 153 152 105  57  51  65 115 149 147 145 144 140
 155 154 156 154 154  95  31  55  90  39  29 112 146 145 144 143
 157 156 153 153 152  51  32 117 146 102  26  66 145 144 142 143
 156 154 154 153 150  39  32 127 151 123  26  51 146 144 142 138
 159 155 154 152 151  63  33  45  75  54  30  60 146 143 142 142
 158 153 155 153 153 137  80  55  59  65  25  64 145 143 141 142
 158 155 156 154 154 149 146 145 142  52  26 105 143 141 141 139
 158 156 156 155 154 128  66  72  41  27  66 138 142 141 141 139
 156 155 154 153 154 127  54  51  67 102 138 143 142 143 141 142
 160 154 154 154 153 152 149 147 145 147 146 144 143 141 141 139
 160 153 154 153 154 152 150 149 147 145 143 143 142 141 140 138
 154 152 150 153 151 149 149 148 146 143 142 140 139 138 137 140

 113 140 142 142 138 135 140 132 136 135 129 128 138 137 133 135
 114 141 140 134 134 136 133 132 130 126 132 129 131 130 128 129
 123 142 144 142 138 141 137 136 132 133 134 133 131 134 133 126
 124 141 144 141 142 141 138 142 140 136 135 132 134 132 132 130
 107 143 144 142 144 117  71  59  61  67 101 128 135 135 131 133
 116 147 145 143 118  44  43  39  36  45  39  62 125 131 136 133
 125 149 146 142  76  44 107 122  67  70  63  45  92 140 140 133
 129 145 146 144  60  86 144 142  90  56 142  57  67 141 141 136
 134 147 152 148  72  59 112 124  51  53 144  79  53 137 145 141
 123 148 150 144 114  47  40  37  47  77 144  77  62 139 148 144
 123 151 151 148 149 105  65  46  70 137 150 136 127 150 148 146
 124 151 148 152 152 150 158 153 151 148 151 152 148 150 149 145
 125 148 148 152 150 151 153 151 152 149 152 151 152 154 150 148
 127 149 151 151 150 151 151 152 152 151 153 151 151 152 150 149
 120 151 151 151 151 156 153 154 154 154 153 147 153 153 149 149
 112 150 154 149 157 160 154 154 151 153 151 151 153 155 156 148
 132 159 162 161 158 162 158 153 159 156 153 154 156 153 154 153
 142 164 164 164 163 162 161 161 161 161 160 159 159 158 158 156
 148 166 166 165 165 165 162 161 161 160 160 160 160 160 158 157
 153 167 168 167 167 165 164 163 162 161 161 161 161 160 159 158
 139 168 170 169 167 136  79  62  68  77 118 155 161 160 161 160
 142 169 171 170 134  48  39  38  38  38  39  81 157 163 162 161
 148 171 171 169  86  48 113 132  66  76  60  42 114 164 163 163
 152 172 173 168  67  94 166 169  97  70 159  58  77 163 166 166
 158 173 172 172  79  63 129 135  60  62 166  83  63 165 168 166
 147 173 173 174 127  45  40  37  40  92 167  83  67 168 169 168
 143 174 175 175 173 116  63  46  79 157 172 147 144 171 172 169
 146 174 175 175 176 174 173 168 173 174 174 173 174 173 173 171
 150 175 176 177 175 176 175 176 174 175 175 174 174 173 173 171
 156 175 175 175 176 175 176 175 174 175 175 175 174 174 174 171
 144 174 176 175 176 175 176 176 174 175 175 175 174 174 174 173
 134 165 173 173 173 175 174 175 173 173 175 174 173 173 172 170
 126 145 144 145 140 143 143 138 142 142 139 139 142 139 138 140
 127 144 146 145 144 144 142 142 142 141 141 141 141 141 140 137
 133 147 147 146 145 145 144 144 143 143 141 141 143 141 141 138
 138 147 148 148 147 146 145 146 146 145 143 142 142 143 142 139
 126 149 150 150 149 112  66  51  60  64 105 138 143 144 143 140
 132 150 152 150 115  29  26  26  30  25  26  66 138 146 143 142
 136 150 152 149  65  39 102 123  54  65  52  27 102 147 145 143
 138 152 153 148  51  90 146 151  75  59 142  41  67 145 147 146
 144 153 151 149  57  55 117 127  45  55 145  72  51 147 149 148
 129 153 154 152 105  31  32  32  33  80 146  66  54 149 150 149
 124 154 155 153 152  95  51  39  63 137 149 128 127 152 152 149
 132 155 154 153 153 154 152 150 151 153 154 154 154 153 154 151
 138 154 154 155 153 154 153 153 152 153 154 155 153 154 153 153
 142 154 155 155 155 156 153 154 154 155 156 156 154 154 154 150
 130 155 155 155 155 154 156 154 155 153 155 156 155 154 153 152
 126 151 160 160 155 155 157 156 159 158 158 158 156 160 160 154

