 139 143 140 131 140 147 148 148 144 140 137 146 146 149 144 148
 140 141 143 146 147 147 146 150 148 147 147 147 147 149 150 152
 148 141 142 143 145 147 146 145 146 146 147 146 146 146 148 147
 141 142 144 146 146 146 144 134 141 142 147 145 145 147 150 150
 145 141 141 143 148  79  55  52  53  77 128 146 143 147 148 149
 144 142 146 147 150  59  78  87  59  49  76 147 143 146 147 146
 139 145 147 147 145 133 141 144 104  45  65 148 145 143 147 146
 139 141 145 145 143 142 146 144 102  50  77 150 142 145 145 148
 145 142 145 143 145 145 145 122  42  50 127 147 143 142 147 151
 143 140 144 144 143 143 112  48  44 108 144 146 144 144 144 147
 145 141 142 141 143  99  48  54 110 134 137 140 143 146 149 149
 145 141 140 147 123  50  43  47  54  54  45 114 146 145 148 148
 139 140 144 146 128  90  96  94  88  93  95 127 142 144 144 146
 136 139 141 142 143 140 144 140 143 146 143 142 140 142 144 147
 137 135 138 139 141 143 140 142 144 143 140 141 142 143 141 138
 142 137 136 137 138 139 139 138 129 133 139 136 136 140 139 138
 159 159 158 158 158 165 166 165 163 161 156 166 166 164 162 160
 161 164 165 166 167 167 168 167 167 168 167 167 168 167 168 167
 162 165 165 167 168 167 167 168 168 168 167 167 167 168 169 168
 162 165 166 166 167 164 160 153 160 164 166 167 167 167 168 166
 159 165 166 166 165  87  56  47  58  82 148 166 167 167 167 166
 163 164 165 165 163  62  78  85  57  43  82 167 167 167 167 168
 164 165 166 166 166 150 166 166 113  42  63 167 167 167 166 167
 160 166 166 167 167 168 167 164 113  40  74 166 168 168 167 167
 161 165 165 167 167 167 167 140  45  48 134 166 167 168 166 166
 162 165 165 166 167 165 129  54  44 119 165 166 167 166 166 166
 160 165 166 166 162 115  47  48 120 155 157 164 167 166 165 166
 162 166 166 166 144  45  40  43  50  53  49 122 166 166 166 165
 165 165 166 166 146 102 104 102  97  99 107 143 166 166 166 166
 160 164 165 165 166 165 164 166 166 166 165 165 166 166 166 166
 157 163 165 165 164 165 166 166 166 166 167 166 166 165 165 164
 153 159 160 161 160 160 161 161 161 161 161 161 159 160 160 161
 144 145 145 140 140 149 149 148 144 142 137 149 151 150 148 147
 146 146 147 148 149 149 150 149 148 150 149 149 150 150 151 151
 147 146 149 149 150 149 149 150 148 149 150 149 149 149 151 152
 149 146 147 148 148 144 142 138 143 146 150 149 148 149 150 154
 146 146 148 148 149  74  46  39  47  68 133 147 148 149 149 155
 149 147 147 147 149  47  61  66  44  31  71 150 149 150 149 153
 148 148 148 148 149 131 148 147 101  30  56 153 150 150 148 154
 144 147 148 148 149 148 150 149 104  30  63 150 149 149 148 153
 146 147 147 149 150 148 149 131  34  35 118 148 148 148 150 153
 148 147 147 148 149 147 118  42  34 104 149 148 149 149 151 152
 145 147 149 149 147 105  38  35 102 141 141 147 147 148 148 150
 147 147 146 147 133  35  30  32  35  39  40  98 148 149 149 149
 151 146 147 147 131  82  86  86  78  80  86 120 149 149 149 153
 147 147 147 147 147 149 148 148 149 147 148 148 148 149 148 153
 142 146 145 147 146 148 148 148 148 147 148 147 147 147 148 151
 143 141 142 143 143 144 145 146 148 146 144 144 142 145 146 150

 148 152 147 150 149 146 146 148 151 147 149 148 146 147 138 138
 144 150 148 150 148 147 147 145 147 144 149 148 144 144 141 139
 149 149 146 147 147 146 143 145 142 144 146 145 144 142 143 140
 146 147 146 145 143 143 145 142 143 144 143 146 142 140 142 136
 146 147 146 145 146 147 148 150 147 146 140 114 127 142 141 136
 137 147 147 147 128  76  65  77 127 144 137  45  95 143 140 139
 140 147 146 142  77  49  45  50  50 108 134  54  93 146 143 133
 144 148 146 141  53  59 104 102  42  44 110  54  88 143 144 129
 148 150 145 134  52  87 144 144 122  48  54  47  94 140 142 138
 148 146 146 144  55  78 141 146 145 112  48  43  96 144 140 139
 147 147 147 146  79  59 133 142 145 143  99  50  90 140 143 139
 140 147 145 146 148 150 145 143 145 143 143 123 128 143 141 138
 131 146 143 146 143 147 147 145 143 144 141 147 146 142 139 137
 140 143 142 144 141 146 147 145 145 144 142 140 144 141 138 136
 143 141 141 142 141 142 145 141 142 140 141 141 140 139 135 137
 139 140 148 141 145 144 139 139 145 143 145 145 139 136 137 142
 160 167 168 166 166 168 167 167 166 166 166 165 166 166 164 161
 162 168 169 168 167 167 166 167 166 166 165 166 166 166 165 160
 164 167 168 167 167 167 167 168 168 166 166 166 166 166 165 160
 166 168 167 167 167 167 167 168 167 167 167 166 166 166 166 159
 166 167 167 167 166 167 167 166 166 166 164 122 143 165 166 161
 156 167 167 166 148  82  63  74 134 165 157  49 107 165 167 161
 161 168 168 164  82  43  42  40  48 119 155  53  99 166 166 161
 163 167 168 160  58  57 113 113  45  44 120  50  97 166 166 161
 165 167 168 153  47  85 166 164 140  54  48  43 102 166 166 161
 166 168 167 160  56  78 166 167 167 129  47  40 104 164 166 161
 165 167 167 164  87  62 150 168 167 165 115  45 102 165 165 160
 158 167 168 167 165 163 166 167 167 167 162 144 146 166 164 160
 158 166 167 166 166 165 166 167 167 166 166 166 166 165 165 161
 158 165 165 166 166 165 166 166 165 165 166 166 166 165 165 160
 159 164 165 165 165 164 165 166 165 165 165 166 165 164 163 159
 159 161 162 162 159 163 164 160 161 162 160 162 165 160 157 153
 147 151 152 154 155 153 154 153 153 152 150 149 153 153 151 150
 148 151 151 150 149 149 148 148 150 151 148 149 149 148 148 146
 150 150 149 149 149 150 150 149 148 149 148 149 149 149 147 145
 151 150 149 148 148 149 150 149 148 149 147 148 149 148 147 142
 149 149 149 149 147 150 153 150 148 148 147  98 120 148 147 144
 137 149 150 150 133  71  56  63 118 149 141  40  86 148 148 144
 142 150 149 146  68  31  30  30  35 104 141  39  80 147 147 146
 144 148 148 143  47  44 101 104  34  34 102  35  78 149 148 148
 148 149 150 138  39  66 147 149 131  42  35  32  86 148 148 146
 149 150 149 142  46  61 148 150 149 118  38  30  86 148 148 145
 149 149 149 144  74  47 131 148 148 147 105  35  82 149 148 144
 140 149 150 148 149 149 149 149 150 149 147 133 131 147 146 143
 140 148 149 148 148 147 148 148 149 148 149 147 147 147 147 143
 145 147 149 147 148 147 148 148 147 147 149 146 147 147 145 142
 145 146 146 146 146 147 148 147 147 147 147 147 146 147 146 141
 144 146 147 149 146 149 148 144 146 148 145 147 151 147 142 143

 138 139 140 136 136 139 133 129 138 139 139 138 137 136 137 142
 138 141 143 142 141 140 143 144 142 140 143 141 139 138 135 137
 147 144 142 140 142 143 146 143 140 144 140 143 142 141 139 136
 146 144 144 142 127  95  93  88  94  96  90 128 146 144 140 139
 148 148 145 146 114  45  54  54  47  43  50 123 147 140 141 145
 149 149 146 143 140 137 134 110  54  48  99 143 141 142 141 145
 147 144 144 144 146 144 108  44  48 112 143 143 144 144 140 143
 151 147 142 143 147 127  50  42 122 145 145 145 143 145 142 145
 148 145 145 142 150  77  50 102 144 146 142 143 145 145 141 139
 146 147 143 145 148  65  45 104 144 141 133 145 147 147 145 139
 146 147 146 143 147  76  49  59  87  78  59 150 147 146 142 144
 149 148 147 143 146 128  77  53  52  55  79 148 143 141 141 145
 150 150 147 145 145 147 142 141 134 144 146 146 146 144 142 141
 147 148 146 146 146 147 146 146 145 146 147 145 143 142 141 148
 152 150 149 147 147 147 147 148 150 146 147 147 146 143 141 140
 148 144 149 146 146 137 140 144 148 148 147 140 131 140 143 139
 161 160 160 159 161 161 161 161 161 161 160 160 161 160 159 153
 164 165 165 166 166 167 166 166 166 166 165 164 165 165 163 157
 166 166 166 166 165 165 166 166 166 164 165 166 165 165 164 160
 166 166 166 166 143 107  99  97 102 104 102 146 166 166 165 165
 165 166 166 166 122  49  53  50  43  40  45 144 166 166 166 162
 166 165 166 167 164 157 155 120  48  47 115 162 166 166 165 160
 166 166 166 167 166 165 119  44  54 129 165 167 166 165 165 162
 166 166 168 167 166 134  48  45 140 167 167 167 167 165 165 161
 167 167 168 168 166  74  40 113 164 167 168 167 167 166 166 160
 167 166 167 167 167  63  42 113 166 166 150 166 166 166 165 164
 168 167 167 167 167  82  43  57  85  78  62 163 165 165 164 163
 166 167 167 167 166 148  82  58  47  56  87 165 166 166 165 159
 166 168 167 167 167 166 164 160 153 160 164 167 166 166 165 162
 168 169 168 167 167 167 168 168 168 167 167 168 167 165 165 162
 167 168 167 168 167 167 168 167 167 168 167 167 166 165 164 161
 160 162 164 166 166 156 161 163 165 166 165 158 158 158 159 159
 150 146 145 142 144 144 146 148 146 145 144 143 143 142 141 143
 151 148 147 147 147 148 147 148 148 148 148 146 147 145 146 142
 153 148 149 148 148 148 147 149 148 148 149 147 147 147 147 147
 153 149 149 149 120  86  80  78  86  86  82 131 147 147 146 151
 149 149 149 148  98  40  39  35  32  30  35 133 147 146 147 147
 150 148 148 147 147 141 141 102  35  38 105 147 149 149 147 145
 152 151 149 149 148 149 104  34  42 118 147 149 148 147 147 148
 153 150 148 148 148 118  35  34 131 149 148 150 149 147 147 146
 153 148 149 149 150  63  30 104 149 150 148 149 148 148 147 144
 154 148 150 150 153  56  30 101 147 148 131 149 148 148 148 148
 153 149 150 149 150  71  31  44  66  61  47 149 147 147 147 149
 155 149 149 148 147 133  68  47  39  46  74 149 148 148 146 146
 154 150 149 148 149 150 146 143 138 142 144 148 148 147 146 149
 152 151 149 149 149 150 149 148 150 149 149 150 149 149 146 147
 151 151 150 150 149 149 150 148 149 150 149 149 148 147 146 146
 147 148 150 151 149 137 142 144 148 149 149 140 140 145 145 144

 142 137 136 139 145 145 143 145 139 139 144 145 141 148 140 139
 137 135 139 140 141 141 140 142 141 145 142 141 142 141 141 143
 136 138 141 144 140 142 144 145 145 147 146 141 144 142 143 140
 137 139 142 146 147 141 144 143 145 147 147 143 146 143 146 131
 138 141 143 128 123 143 143 145 143 145 150 148 146 145 147 140
 139 143 140  90  50  99 143 145 142 133  59  79 146 147 147 147
 139 140 144  96  43  48 112 145 146 141  78  55 144 146 146 148
 138 142 140  94  47  54  48 122 144 144  87  52 134 145 150 148
 129 144 143  88  54 110  44  42 102 104  59  53 141 146 148 144
 133 143 146  93  54 134 108  50  50  45  49  77 142 146 147 140
 139 140 143  95  45 137 144 127  77  65  76 128 147 147 147 137
 136 141 142 127 114 140 146 147 150 148 147 146 145 146 147 146
 136 142 140 142 146 143 144 143 142 145 143 143 145 146 147 146
 140 143 142 144 145 146 144 142 145 143 146 147 147 146 149 149
 139 141 144 144 148 149 144 147 145 147 147 148 150 148 150 144
 138 138 147 146 148 149 147 151 148 146 146 149 150 147 152 148
 153 157 160 165 162 160 162 161 160 164 163 159 162 162 161 159
 159 163 164 165 166 165 165 165 166 165 164 165 165 165 164 159
 160 165 165 166 166 166 165 165 166 166 165 166 166 165 165 158
 161 165 165 166 166 166 166 167 167 166 165 166 166 167 166 158
 160 164 166 146 144 162 167 167 167 166 163 165 167 168 167 158
 160 165 165 102  45 115 165 167 168 150  62  87 164 167 167 165
 161 166 164 104  40  47 129 167 167 166  78  56 160 167 168 166
 161 166 166 102  43  48  54 140 164 166  85  47 153 168 167 165
 161 166 166  97  50 120  44  45 113 113  57  58 160 168 167 163
 161 166 166  99  53 155 119  48  40  42  43  82 164 168 168 161
 161 167 165 107  49 157 165 134  74  63  82 148 166 167 167 156
 161 166 165 143 122 164 166 166 166 167 167 166 167 167 167 166
 159 166 166 166 166 167 167 167 168 167 167 167 167 167 168 166
 160 165 166 166 166 166 166 168 168 167 167 167 167 168 167 164
 160 165 166 166 166 165 166 166 167 166 167 167 168 169 168 162
 161 164 166 166 165 166 166 166 167 167 168 166 166 168 167 160
 143 142 147 151 147 145 148 146 144 148 149 146 149 147 146 144
 141 146 147 146 147 147 147 147 147 148 147 146 146 146 146 145
 142 145 147 147 146 149 147 147 148 148 147 148 147 149 147 145
 143 147 147 147 147 149 148 149 148 148 147 148 148 149 148 140
 143 146 147 131 133 147 149 150 149 149 149 149 148 150 149 140
 144 148 149  82  35 105 147 148 148 131  47  74 144 149 149 149
 145 148 148  86  30  38 118 149 150 148  61  46 142 149 150 149
 146 148 148  86  32  35  42 131 149 147  66  39 138 150 149 148
 148 148 149  78  35 102  34  34 104 101  44  47 143 148 148 144
 146 147 147  80  39 141 104  35  30  30  31  68 146 149 150 142
 144 148 148  86  40 141 149 118  63  56  71 133 150 150 149 137
 144 147 148 120  98 147 148 148 150 153 150 147 149 149 149 149
 142 147 148 149 148 147 149 148 149 150 149 148 148 149 150 151
 145 147 149 149 149 148 149 148 149 150 150 149 149 149 150 150
 146 148 148 149 149 148 151 150 148 148 149 149 150 151 151 148
 150 151 153 153 149 150 152 153 153 154 153 155 154 152 151 147

