 150 143 149 147 145 148 146 148 150 148 150 148 148 153 154 147
 154 150 148 147 150 152 149 147 147 146 147 148 149 151 152 156
 156 150 150 144 149 150 147 144 144 145 147 146 152 150 150 155
 151 147 151 148 144 134 136 142 139 141 137 146 147 148 150 153
 149 145 147 145 136  50  42  47  55  53  57 150 148 148 150 151
 152 146 146 146 135  38  43  87  90  94 100 150 149 150 148 145
 149 143 141 144 145  40  60 146 138 142 144 149 146 146 147 148
 148 144 142 145 142  48  45  48  52  64 122 147 145 141 149 147
 142 143 143 146 141  82 104  95  68  45  51 147 147 147 148 147
 152 144 144 145 143 143 141 143 131  44  41 135 147 146 147 146
 151 142 143 145 117  99 126 139 101  41  55 145 144 147 146 147
 146 141 142 144 103  46  46  39  42  50 115 146 149 149 146 150
 148 142 139 141 127 114  91  97 112 139 148 146 148 145 142 147
 152 141 146 143 142 143 143 148 147 142 145 145 143 146 145 144
 150 142 143 144 144 145 144 145 144 143 141 144 145 143 147 146
 142 139 141 137 138 131 137 141 138 138 140 141 126 136 139 136
 162 167 167 167 169 171 170 168 168 169 170 172 173 172 171 167
 170 170 170 171 170 172 169 170 171 171 171 172 173 173 172 172
 169 171 170 170 169 171 170 170 171 171 171 171 171 173 172 171
 165 169 168 169 167 159 158 161 162 164 158 170 172 173 171 169
 166 168 168 169 155  55  50  49  53  47  60 169 171 171 170 166
 168 168 169 168 154  42  44  93  96 105 109 170 170 171 170 167
 167 168 168 168 162  41  52 156 161 164 166 168 169 172 172 168
 165 168 168 167 161  46  43  52  49  66 136 168 170 172 170 168
 166 168 168 168 161  93 107 101  67  41  57 167 170 169 170 168
 167 167 168 168 166 165 166 166 145  41  44 152 170 170 169 167
 168 167 167 168 133 115 149 156 110  40  59 162 170 170 169 168
 168 168 168 167 117  47  46  43  45  53 124 169 170 170 169 170
 164 167 168 167 158 123 101 101 117 148 168 169 169 170 169 169
 165 167 167 168 167 168 167 167 167 169 168 170 169 169 169 167
 165 167 167 166 167 167 167 168 168 169 168 168 168 168 168 163
 161 157 158 160 161 158 161 163 160 159 161 163 159 159 162 161
 152 149 151 149 150 151 151 149 148 152 152 151 153 154 154 154
 154 151 150 152 151 153 150 150 152 152 152 153 154 153 153 154
 152 151 151 151 151 152 151 151 152 151 152 152 153 154 152 151
 151 151 150 150 148 142 141 145 146 147 141 152 153 154 153 151
 149 150 150 150 139  42  39  40  41  33  46 151 152 152 153 151
 150 149 150 149 141  29  34  79  75  84  91 154 152 152 151 153
 153 150 149 149 151  28  46 143 148 146 148 151 150 152 151 156
 151 149 149 149 147  39  31  41  43  60 125 150 150 153 152 157
 148 149 148 147 141  79  84  82  54  30  44 152 151 151 152 153
 150 149 149 149 147 147 148 147 133  29  27 131 151 151 150 152
 145 148 148 148 116  95 131 140  98  30  45 142 150 151 150 152
 149 148 149 148 104  32  32  34  29  36 108 151 151 151 150 153
 148 148 148 149 138 102  86  83  93 123 148 149 150 151 150 151
 148 147 147 147 150 149 148 149 149 149 150 150 150 150 150 151
 149 148 148 148 149 148 149 149 148 150 149 150 149 149 149 152
 144 140 143 142 142 143 146 147 144 142 143 146 144 144 146 150

 147 156 155 153 151 145 148 147 147 146 147 150 147 144 146 136
 154 152 150 150 150 148 147 149 148 147 146 146 142 145 147 139
 153 151 150 148 148 150 146 141 147 146 147 149 145 146 143 136
 148 149 152 147 148 149 146 145 147 147 144 149 148 143 145 126
 148 148 146 146 150 150 149 147 147 135 145 146 146 145 144 141
 150 147 147 137  57 100 144 122  51  41  55 115 148 145 141 140
 148 146 145 141  53  94 142  64  45  44  41  50 139 142 143 138
 150 147 144 139  55  90 138  52  68 131 101  42 112 147 144 138
 148 147 144 142  47  87 146  48  95 143 139  39  97 148 145 141
 146 149 147 136  42  43  60  45 104 141 126  46  91 143 144 137
 148 152 150 134  50  38  40  48  82 143  99  46 114 143 145 131
 145 150 149 144 136 135 145 142 141 143 117 103 127 142 144 138
 147 147 144 148 145 146 144 145 146 145 145 144 141 143 144 137
 149 148 150 151 147 146 141 142 143 144 143 142 139 146 143 141
 143 150 150 147 145 146 143 144 143 144 142 141 142 141 142 139
 150 154 156 151 149 152 149 148 142 152 151 146 148 152 150 142
 167 172 171 169 166 167 168 168 168 167 168 170 169 167 163 161
 171 172 172 171 170 170 172 170 170 169 169 169 169 169 168 162
 172 173 173 173 171 171 172 172 169 170 170 170 170 169 168 159
 173 173 171 172 171 170 169 170 170 170 170 170 169 169 168 159
 172 172 171 170 169 170 168 168 167 152 162 169 169 170 168 163
 170 171 171 158  60 109 166 136  57  44  59 124 168 168 168 161
 169 171 171 164  47 105 164  66  41  41  40  53 148 169 169 159
 168 171 171 162  53  96 161  49  67 145 110  45 117 167 168 160
 168 170 170 161  49  93 156  52 101 166 156  43 101 167 168 163
 170 169 170 158  50  44  52  43 107 166 149  46 101 167 167 161
 171 172 171 159  55  42  41  46  93 165 115  47 123 168 167 158
 169 170 169 167 155 154 162 161 161 166 133 117 158 167 167 161
 167 171 170 169 169 168 168 167 168 168 168 167 167 168 166 160
 167 170 170 168 168 169 168 168 168 168 167 168 168 167 167 158
 167 170 171 169 168 168 168 168 168 167 167 168 167 167 167 157
 162 170 169 165 166 168 167 165 166 167 168 168 164 165 165 161
 154 154 151 151 151 153 156 157 153 152 152 153 151 151 152 150
 154 153 152 153 153 151 151 152 152 150 150 150 150 150 149 146
 154 153 154 154 152 152 152 153 151 151 151 151 151 150 149 144
 153 154 153 153 152 152 150 150 151 151 150 151 150 150 149 144
 151 153 152 152 151 154 151 150 152 131 142 151 149 150 150 146
 152 152 152 141  46  91 148 125  44  27  45 108 148 150 149 143
 152 152 151 147  33  84 146  60  30  29  30  36 123 149 150 142
 148 152 152 146  41  75 148  43  54 133  98  29  93 149 148 144
 149 150 151 145  40  79 143  41  82 147 140  34  83 149 149 147
 151 150 151 141  39  34  46  31  84 148 131  32  86 148 149 146
 151 153 152 142  42  29  28  39  79 147  95  32 102 149 148 143
 150 151 151 148 139 141 151 147 141 147 116 104 138 150 149 142
 149 152 151 150 150 149 149 149 147 149 148 148 149 147 148 142
 151 150 151 150 150 150 149 149 148 149 148 149 148 147 148 143
 149 151 151 151 150 149 150 149 149 149 148 148 148 147 148 140
 152 154 152 151 149 150 153 151 148 150 145 149 148 148 149 144

 136 139 136 126 141 140 138 138 141 137 131 138 137 141 139 142
 146 147 143 145 144 141 143 144 145 144 145 144 144 143 142 150
 144 145 146 143 145 145 142 147 148 143 143 142 143 146 141 152
 147 142 145 148 146 148 139 112  97  91 114 127 141 139 142 148
 150 146 149 149 146 115  50  42  39  46  46 103 144 142 141 146
 147 146 147 144 145  55  41 101 139 126  99 117 145 143 142 151
 146 147 146 147 135  41  44 131 143 141 143 143 145 144 144 152
 147 148 147 147 147  51  45  68  95 104  82 141 146 143 143 142
 147 149 141 145 147 122  64  52  48  45  48 142 145 142 144 148
 148 147 146 146 149 144 142 138 146  60  40 145 144 141 143 149
 145 148 150 149 150 100  94  90  87  43  38 135 146 146 146 152
 151 150 148 148 150  57  53  55  47  42  50 136 145 147 145 149
 153 150 148 147 146 137 141 139 142 136 134 144 148 151 147 151
 155 150 150 152 146 147 145 144 144 147 150 149 144 150 150 156
 156 152 151 149 148 147 146 147 147 149 152 150 147 148 150 154
 147 154 153 148 148 150 148 150 148 146 148 145 147 149 143 150
 161 162 159 159 163 161 159 160 163 161 158 161 160 158 157 161
 163 168 168 168 168 168 169 168 168 167 167 167 166 167 167 165
 167 169 169 169 170 168 169 167 167 167 168 167 168 167 167 165
 169 169 170 169 169 168 148 117 101 101 123 158 167 168 167 164
 170 169 170 170 169 124  53  45  43  46  47 117 167 168 168 168
 168 169 170 170 162  59  40 110 156 149 115 133 168 167 167 168
 167 169 170 170 152  44  41 145 166 166 165 166 168 168 167 167
 168 170 169 170 167  57  41  67 101 107  93 161 168 168 168 166
 168 170 172 170 168 136  66  49  52  43  46 161 167 168 168 165
 168 172 172 169 168 166 164 161 156  52  41 162 168 168 168 167
 167 170 171 170 170 109 105  96  93  44  42 154 168 169 168 168
 166 170 171 171 169  60  47  53  49  50  55 155 169 168 168 166
 169 171 173 172 170 158 164 162 161 158 159 167 169 168 169 165
 171 172 173 171 171 171 171 171 170 170 171 169 170 170 171 169
 172 172 173 173 172 171 171 171 170 169 172 170 171 170 170 170
 167 171 172 173 172 170 169 168 168 170 171 169 167 167 167 162
 150 146 144 144 146 143 142 144 147 146 143 142 142 143 140 144
 152 149 149 149 150 149 150 148 149 149 148 149 148 148 148 149
 151 150 150 150 150 150 149 149 149 148 149 150 147 147 147 148
 151 150 151 150 149 148 123  93  83  86 102 138 149 148 148 148
 153 150 151 151 151 108  36  29  34  32  32 104 148 149 148 149
 152 150 151 150 142  45  30  98 140 131  95 116 148 148 148 145
 152 150 151 151 131  27  29 133 147 148 147 147 149 149 149 150
 153 152 151 151 152  44  30  54  82  84  79 141 147 148 149 148
 157 152 153 150 150 125  60  43  41  31  39 147 149 149 149 151
 156 151 152 150 151 148 146 148 143  46  28 151 149 149 150 153
 153 151 152 152 154  91  84  75  79  34  29 141 149 150 149 150
 151 153 152 152 151  46  33  41  40  39  42 139 150 150 150 149
 151 153 154 153 152 141 147 146 145 141 142 148 150 150 151 151
 151 152 154 153 152 152 151 152 151 151 152 151 151 151 151 152
 154 153 153 154 153 152 152 152 150 150 153 151 152 150 151 154
 154 154 154 153 151 152 152 148 149 151 151 150 149 151 149 152

 142 150 152 148 146 151 152 142 148 149 152 149 151 156 154 150
 139 142 141 142 141 142 144 143 144 143 146 145 147 150 150 143
 141 143 146 139 142 143 144 143 142 141 146 147 151 150 148 149
 137 144 143 141 144 145 145 146 145 144 146 145 148 144 147 147
 138 144 142 127 103 117 143 141 142 145 135 136 144 149 150 145
 131 145 143 114  46  99 143  82  48  40  38  50 134 150 152 148
 137 144 143  91  46 126 141 104  45  60  43  42 136 147 149 146
 141 145 148  97  39 139 143  95  48 146  87  47 142 144 147 148
 138 144 147 112  42 101 131  68  52 138  90  55 139 144 147 150
 138 143 142 139  50  41  44  45  64 142  94  53 141 145 146 148
 140 141 145 148 115  55  41  51 122 144 100  57 137 147 147 150
 141 144 145 146 146 145 135 147 147 149 150 150 146 146 148 148
 126 145 143 148 149 144 147 147 145 146 149 148 147 152 149 148
 136 143 146 145 149 147 146 147 141 146 150 148 148 150 151 153
 139 147 145 142 146 146 147 148 149 147 148 150 150 150 152 154
 136 146 144 147 150 147 146 147 147 148 145 151 153 155 156 147
 161 165 165 164 168 168 167 166 165 167 168 166 165 169 170 162
 157 167 167 167 168 167 167 168 168 168 168 168 169 171 170 167
 158 167 167 168 168 167 168 168 168 168 169 168 168 170 170 167
 160 166 168 167 167 168 168 168 167 168 168 169 169 170 171 167
 161 167 167 158 117 133 166 161 161 162 154 155 167 169 170 169
 158 167 168 123  47 115 165  93  46  41  42  55 159 171 172 171
 161 167 167 101  46 149 166 107  43  52  44  50 158 170 169 170
 163 168 167 101  43 156 166 101  52 156  93  49 161 170 170 168
 160 168 167 117  45 110 145  67  49 161  96  53 162 171 171 168
 159 169 169 148  53  40  41  41  66 164 105  47 164 171 171 169
 161 168 168 168 124  59  44  57 136 166 109  60 158 171 171 170
 163 168 170 169 169 162 152 167 168 168 170 169 170 171 172 172
 159 168 169 169 170 170 170 170 170 169 170 171 172 171 173 173
 159 168 169 170 170 170 170 169 172 172 171 171 173 173 173 172
 162 168 169 169 169 169 169 170 170 172 170 170 171 172 172 171
 161 163 167 169 170 168 167 168 168 168 167 166 169 171 172 167
 144 149 148 148 149 145 150 148 151 153 150 149 151 152 154 152
 140 148 147 148 148 148 149 149 149 150 149 150 151 151 151 149
 143 148 147 148 149 148 149 148 149 149 150 150 150 151 150 151
 142 148 147 149 148 148 149 147 149 149 149 150 150 151 152 149
 142 149 150 138 104 116 147 141 147 151 141 139 148 151 151 150
 143 148 149 102  32  95 147  79  39  28  29  42 142 152 153 151
 146 149 148  86  32 131 148  84  31  46  34  39 141 151 150 151
 147 149 149  83  34 140 147  82  41 143  79  40 145 151 150 149
 144 148 149  93  29  98 133  54  43 148  75  41 146 152 152 148
 142 150 149 123  36  30  29  30  60 146  84  33 147 151 152 152
 143 149 150 148 108  45  27  44 125 148  91  46 141 152 152 152
 146 150 150 149 151 142 131 152 150 151 154 151 152 152 153 151
 144 149 150 150 151 150 151 151 150 150 152 152 153 153 154 153
 144 149 150 151 151 151 151 151 153 152 152 152 154 154 153 154
 146 149 150 150 150 150 150 152 152 151 151 153 153 152 153 154
 150 152 151 151 153 152 152 153 157 156 153 151 151 151 154 154

